按	a
吧	b
宝	bc
笨	bf
甭	bg
逼	bi
背	bw
此	c
猜	cd
打	d
搭	da
道	dc
冻	ds
逗	dz
嗯	e
发	f
份	ff
疯	fg
复	fu
管	g
搞	gc
钙	gd
哥	ge
官	gr
故	gu
化	h
壶	hu
华	hx
扯	ie
程	ig
臭	iz
见	j
今	jb
极	ji
贱	jm
居	ju
佳	jx
块	k
抠	kz
立	l
溜	lq
嘛	m
骂	ma
梅	mw
哪	n
浓	ns
期	q
弃	qi
缺	qt
入	r
惹	re
忍	rf
扔	rg
随	s
寺	si
它	t
淘	tc
疼	tg
替	ti
舔	tm
通	ts
退	tv
十	u
省	ug
室	ui
守	uz
之	v
招	vc
症	vg
战	vj
终	vs
位	w
文	wf
忘	wh
玩	wj
性	x
心	xb
型	xk
凶	xs
隐	yb
野	ye
杨	yh
严	yj
园	yr
友	yz
子	z
遭	zc
揍	zz
行驶	xkui
佛庙	fomn
码流	malq
卡口	kakz
阿班	aabj
阿苯	aabf
阿伯	aabo
阿布	aabu
阿城	aaig
阿道	aadc
阿爹	aadp
阿端	aadr
阿飞	aafw
阿公	aags
阿訇	aahs
阿姐	aajp
阿桔	aaju
阿咖	aaka
阿乐	aale
阿里	aali
阿联	aalm
阿鲁	aalu
阿伦	aaly
阿盟	aamg
阿穆	aamu
阿囡	aanj
阿片	aapm
阿沁	aaqb
阿荣	aars
阿嫂	aasc
阿婶	aauf
阿嚏	aati
阿托	aato
锕系	aaxi
爱邦	aibh
艾本	aibf
艾草	aicc
矮凳	aidg
艾迪	aidi
哀吊	aidn
挨冻	aids
挨斗	aidz
艾恩	aien
爱芬	aiff
艾丰	aifg
艾恒	aihg
哀鸿	aihs
爱辉	aihv
挨家	aijx
挨肩	aijm
哀叫	aijn
挨靠	aikc
哀恳	aikf
艾拉	aila
埃兰	ailj
艾朗	ailh
艾雷	ailw
埃林	ailb
癌瘤	ailq
艾略	ailt
艾罗	ailo
癌魔	aimo
碍难	ainj
爱女	ainv
挨批	aipi
爱犬	aiqr
蔼然	airj
暧舒	aiuu
艾太	aitd
艾条	aitn
艾瓦	aiwa
爱维	aiww
艾旭	aixu
癌肿	aivs
暗坝	anba
胺泵	anbg
鞍鼻	anbi
案秤	anig
暗锤	aniv
安达	anda
暗洞	ands
安多	andz
鞍钢	angh
安国	ango
暗魂	anhy
安咳	anke
安坤	anky
安来	anld
安澜	anlj
暗雷	anlw
安龙	anls
按脉	anmd
安曼	anmj
暗矛	anmc
暗昧	anmw
安谧	anmi
安脑	annc
安努	annu
暗盘	anpj
岸炮	anpc
暗皮	anpi
安平	anpk
安丘	anqq
暗弱	anro
安塞	ansd
暗色	anse
安顺	anuy
安嗽	ansz
庵堂	anth
安替	anti
安恬	antm
安图	antu
安卧	anwo
暗雾	anwu
安歇	anxp
按序	anxu
安阳	anyh
暗云	anyy
安匝	anza
安扎	anva
安枕	anvf
暗转	anvr
昂昂	ahah
昂藏	ahch
昂奋	ahff
昂仁	ahrf
凹版	aobj
奥贝	aobw
奥本	aobf
奥比	aobi
鏖兵	aobk
奥茨	aoci
奥杜	aodu
奥芬	aoff
奥孚	aofu
奥根	aogf
澳广	aogl
敖汉	aohj
奥赫	aohe
懊恨	aohf
奥佳	aojx
熬煎	aojm
傲角	aojn
凹镜	aojk
奥克	aoke
奥兰	aolj
澳朗	aolh
奥雷	aolw
奥伦	aoly
奥玛	aoma
奥美	aomw
奥姆	aomu
澳能	aong
奥妮	aoni
澳诺	aono
奥平	aopk
傲然	aorj
奥森	aosf
奥莎	aoua
傲霜	aoul
奥斯	aosi
奥松	aoss
奥索	aoso
奥特	aote
凹体	aoti
鳌头	aotz
傲物	aowu
靶标	babn
巴伯	babo
吧嗒	bada
巴德	bade
巴登	badg
靶点	badm
巴东	bads
把儿	baer
把酒	bajq
扒开	bakk
巴坎	bakj
巴莱	bald
把揽	balj
霸灵	balk
巴隆	bals
笆篓	balz
坝美	bamw
巴南	banj
吧女	banv
靶瀑	bapu
菝葜	baqx
灞桥	baqn
巴青	baqk
拔取	baqu
拔群	baqy
巴森	basf
巴沙	baua
拔丝	basi
八宿	basu
巴塘	bath
巴特	bate
巴替	bati
把头	batz
八位	baww
八邪	baxp
把兄	baxs
鲅鱼	bayu
把斋	bavd
八珍	bavf
八正	bavg
巴中	bavs
拔擢	bavo
百艾	bdai
百奥	bdao
拜尔	bder
白刚	bdgh
白垢	bdgz
白喉	bdhz
白蔻	bdkz
白蜡	bdla
白濑	bdld
白兰	bdlj
白朗	bdlh
摆列	bdlp
白茅	bdmc
拜盟	bdmg
柏木	bdmu
百衲	bdna
百宁	bdnk
白奴	bdnu
白胖	bdph
百辟	bdpi
拜票	bdpn
白前	bdqm
白区	bdqu
拜泉	bdqr
白饶	bdrc
白热	bdre
百礽	bdrg
百蕊	bdrv
白润	bdry
拜扫	bdsc
白芍	bduc
白霜	bdul
白塔	bdta
白铁	bdtp
白厅	bdtk
白铜	bdts
白文	bdwf
白下	bdxx
白熊	bdxs
柏油	bdyz
百战	bdvj
白术	bdvu
白撞	bdvl
摆桌	bdvo
板蚌	bjbh
板擦	bjca
板层	bjcg
板床	bjil
板锉	bjco
半大	bjda
伴儿	bjer
班费	bjfw
板鼓	bjgu
板胡	bjhu
板卡	bjka
版刻	bjke
版口	bjkz
半醌	bjky
半拉	bjla
板脸	bjlm
半硫	bjlq
斑蝥	bjmc
瓣膜	bjmo
版纳	bjna
班期	bjqi
板桥	bjqn
半群	bjqy
班赛	bjsd
板苏	bjsu
拌蒜	bjsr
板塘	bjth
板条	bjtn
版头	bjtz
板瓦	bjwa
扮戏	bjxi
半夏	bjxx
版心	bjxb
半休	bjxq
斑疹	bjvf
半种	bjvs
帮备	bhbw
膀臂	bhbi
棒冰	bhbk
帮补	bhbu
棒操	bhcc
帮厨	bhiu
帮凑	bhcz
傍黑	bhhw
磅卡	bhka
邦联	bhlm
邦纳	bhna
帮凝	bhnk
邦诺	bhno
蚌肉	bhrz
榜书	bhuu
傍水	bhuv
帮套	bhtc
邦亭	bhtk
帮同	bhts
绑腿	bhtv
榜尾	bhww
傍午	bhwu
帮闲	bhxm
邦欣	bhxb
傍依	bhyi
梆硬	bhyk
绑扎	bhza
棒针	bhvf
磅重	bhvs
报靶	bcba
胞波	bcbo
包产	bcij
刨床	bcil
报春	bciy
褒词	bcci
薄脆	bccv
报端	bcdr
孢粉	bcff
宝号	bchc
保喉	bchz
宝眷	bcjr
保康	bckh
胞口	bckz
报矿	bckl
抱愧	bckv
暴敛	bclm
保量	bcll
抱龙	bcls
宝轮	bcly
豹猫	bcmc
保苗	bcmn
豹群	bcqy
爆燃	bcrj
暴热	bcre
孢蒴	bcuo
报童	bcts
包退	bctv
胞吞	bcty
宝玩	bcwj
保旺	bcwh
抱窝	bcwo
雹灾	bczd
北侧	bwce
北朝	bwic
北辰	bwif
北城	bwig
辈出	bwiu
北川	bwir
北槌	bwiv
倍丛	bwcs
杯灯	bwdg
贝雕	bwdn
贝尔	bwer
北伐	bwfa
背根	bwgf
备耕	bwgg
北汉	bwhj
北航	bwhh
备荒	bwhl
北郊	bwjn
碑碣	bwjp
背筐	bwkl
贝莱	bwld
贝劳	bwlc
备料	bwln
北流	bwlq
背篓	bwlz
贝苗	bwmn
悖谬	bwmq
被膜	bwmo
被难	bwnj
倍能	bwng
悖逆	bwni
被虐	bwnt
倍然	bwrj
背人	bwrf
贝萨	bwsa
杯赛	bwsd
焙烧	bwuc
悲声	bwug
被刷	bwux
倍顺	bwuy
贝思	bwsi
倍速	bwsu
悲酸	bwsr
背疼	bwtg
碑帖	bwtp
碑亭	bwtk
北图	bwtu
卑污	bwwu
倍兴	bwxk
被絮	bwxu
悲咽	bwye
悲翼	bwyi
背债	bwvd
北障	bwvh
被罩	bwvc
北周	bwvz
备足	bwzu
碑座	bwzo
苯并	bfbk
本册	bfce
奔窜	bfcr
畚斗	bfdz
奔放	bffg
苯环	bfhr
奔狼	bflh
本利	bfli
奔忙	bfmh
本末	bfmo
本娜	bfna
本尼	bfni
本色	bfud
奔头	bftz
本我	bfwo
奔泻	bfxp
苯氧	bfyh
奔涌	bfys
苯乍	bfva
本宅	bfvd
本章	bfvh
本证	bfvg
泵房	bgfg
崩沸	bgfw
蹦高	bggc
祊河	bghe
绷簧	bghl
崩漏	bglz
崩落	bglo
蹦跳	bgtn
泵站	bgvj
崩症	bgvg
绷子	bgzi
必澳	biao
荜茇	biba
碧草	bicc
鼻长	biih
臂丛	bics
必存	bicy
避错	bico
笔答	bida
笔调	bidn
鼻窦	bidz
鼻儿	bier
鼻根	bigf
壁挂	bigx
鼻疽	biju
鼻裂	bilp
比邻	bilb
鄙陋	bilz
避乱	bilr
蓖麻	bima
比内	binw
必能	bing
比年	binm
比配	bipw
壁泉	biqr
比热	bire
笔润	biry
璧山	biuj
毕设	biue
鼻深	biuf
鄙俗	bisu
笔算	bisr
碧土	bitu
逼向	bixl
毕肖	bixn
壁压	biya
泌阳	biyh
碧月	biyt
逼仄	bize
笔札	biva
笔战	bivj
臂肘	bivz
鼻赘	bivv
边坝	bmba
变产	bmij
鞭虫	bmis
贬黜	bmiu
编创	bmil
边带	bmdd
变度	bmdu
边儿	bmer
便函	bmhj
编后	bmhz
编列	bmlp
扁率	bmlv
编目	bmmu
辩难	bmnj
变牛	bmnq
编配	bmpw
便盆	bmpf
便桥	bmqn
辨清	bmqk
变声	bmug
辩说	bmuo
扁桃	bmtc
变奏	bmzz
裱褙	bnbw
表册	bnce
标称	bnig
标灯	bndg
标调	bndn
标定	bndk
膘肥	bnfw
标高	bngc
标号	bnhc
鳔胶	bnjn
镖客	bnke
标量	bnll
表膜	bnmo
表盘	bnpj
表位	bnww
标远	bnyr
表征	bnvg
彪壮	bnvl
别价	bpjp
别恋	bplm
别绪	bpxu
殡车	bbie
摈斥	bbii
摈除	bbiu
宾川	bbir
宾词	bbci
鬓发	bbfa
宾服	bbfu
髌骨	bbgu
滨湖	bbhu
宾吉	bbji
宾尼	bbni
濒死	bbsi
傧相	bbxl
滨欣	bbxb
秉笔	bkbi
病残	bkcj
冰场	bkih
丙醇	bkiy
冰镩	bkcr
冰胆	bkdj
摒挡	bkdh
兵丁	bkdk
冰盾	bkdy
饼饵	bker
冰反	bkfj
冰挂	bkgx
冰寒	bkhj
冰花	bkhx
冰黄	bkhl
冰火	bkho
柄节	bkjp
冰晶	bkjk
摒绝	bkjt
冰抗	bkkh
病况	bkkl
冰凌	bklk
冰木	bkmu
冰凝	bknk
冰片	bkpm
冰枪	bkql
冰橇	bkqn
病弱	bkro
屏声	bkug
丙酸	bksr
冰坨	bkto
丙烷	bkwj
并网	bkwh
兵燹	bkxm
兵贼	bkzw
兵站	bkvj
冰砖	bkvr
病状	bkvl
冰锥	bkvv
禀奏	bkzz
兵卒	bkzu
驳岸	boan
薄产	boij
驳船	boir
薄唇	boiy
波茨	boci
波荡	bodh
博丁	bodk
拨儿	boer
播放	bofg
鹁鸽	boge
伯根	bogf
搏功	bogs
博湖	bohu
剥甲	bojx
博健	bojm
播讲	bojl
波节	bojp
博静	bojk
波卡	boka
博抗	bokh
波列	bolp
波密	bomi
搏拿	bona
波尼	boni
博宁	bonk
博平	bopk
博洽	boqx
波前	boqm
博球	boqq
波群	boqy
勃然	borj
拨冗	bors
泊瑞	borv
播散	bosj
博山	bouj
博帅	bouk
博坦	botj
波特	bote
薄田	botm
泊头	botz
剥脱	boto
亳县	boxm
博效	boxn
博欣	boxb
伯兄	boxs
博野	boye
钵盂	boyu
波源	boyr
驳杂	boza
薄葬	bozh
搏战	bovj
博正	bovg
亳州	bovz
博赚	bovr
补报	bubc
布店	budm
步调	budn
不迭	budp
不独	budu
补角	bujn
不倦	bujr
布控	buks
不吝	bulb
不毛	bumc
不敏	bumb
不睦	bumu
捕拿	buna
补脑	bunc
不破	bupo
布裙	buqy
布伞	busj
补色	buse
不俗	busu
不遂	busv
步态	butd
布特	bute
布条	butn
埠头	butz
补选	buxr
补血	buxt
补液	buye
布展	buvj
补正	buvg
补种	buvs
补缀	buvv
擦黑	cahw
擦烂	calj
擦音	cayb
擦浴	cayu
擦澡	cazc
菜案	cdan
菜帮	cdbh
裁并	cdbk
财帛	cdbo
菜场	cdih
彩绸	cdiz
彩瓷	cdci
彩灯	cddg
彩雕	cddn
彩蝶	cddp
财东	cdds
菜豆	cddz
裁断	cddr
彩二	cder
菜饭	cdfj
才分	cdff
菜瓜	cdgx
财货	cdho
菜窖	cdjn
菜金	cdjb
彩鹫	cdjq
才具	cdju
彩卷	cdjr
彩扩	cdko
采乐	cdle
财粮	cdll
彩楼	cdlz
采买	cdmd
采煤	cdmw
财年	cdnm
菜牛	cdnq
菜农	cdns
彩棚	cdpg
才人	cdrf
彩三	cdsj
采收	cduz
菜蔬	cduu
彩塑	cdsu
彩陶	cdtc
采挖	cdwa
菜系	cdxi
彩炫	cdxr
采择	cdze
残本	cjbf
残部	cjbu
参柴	cjid
残次	cjci
参订	cjdk
蚕蛾	cjee
残根	cjgf
参桂	cjgv
参皇	cjhl
参会	cjhv
参将	cjjl
残卷	cjjr
惨况	cjkl
惨厉	cjli
残木	cjmu
参内	cjnw
蚕农	cjns
残片	cjpm
残品	cjpb
参评	cjpk
参杞	cjqi
残秋	cjqq
残热	cjre
蚕桑	cjsh
残山	cjuj
参芍	cjuc
残髓	cjsv
参威	cjww
惨象	cjxl
参芎	cjxs
残雪	cjxt
蚕蛹	cjys
残障	cjvh
参子	cjzi
惭怍	cjzo
苍尘	chif
藏躲	chdz
苍耳	cher
藏帆	chfj
仓房	chfg
藏画	chhx
藏奸	chjm
沧江	chjl
沧浪	chlh
仓廪	chlb
苍龙	chls
苍鹭	chlu
苍南	chnj
仓容	chrs
舱室	chui
伧俗	chsu
苍梧	chwu
苍溪	chxi
沧县	chxm
苍辛	chxb
藏雄	chxs
藏掖	chye
苍郁	chyu
沧源	chyr
沧州	chvz
苍术	chvu
藏踪	chzs
草编	ccbm
草铂	ccbo
草测	ccce
槽车	ccie
草虫	ccis
草刺	ccci
漕渡	ccdu
草垛	ccdz
草房	ccfg
糙哥	ccge
草菇	ccgu
草果	ccgo
草海	cchd
槽号	cchc
漕河	cche
草荒	cchl
草灰	cchv
草鸡	ccji
草荐	ccjm
漕粮	ccll
草皮	ccpi
草坡	ccpo
操切	ccqp
操琴	ccqb
槽群	ccqy
草人	ccrf
操神	ccuf
草酸	ccsr
草堂	ccth
草体	ccti
曹县	ccxm
操行	ccxk
草须	ccxu
槽牙	ccya
操演	ccyj
漕运	ccyy
草泽	ccze
草种	ccvs
侧柏	cebd
测报	cebc
测查	ceia
测产	ceij
侧根	cegf
测光	cegl
册亨	cehg
测交	cejn
侧近	cejb
测井	cejk
策勒	cele
侧链	celm
侧漏	celz
策论	cely
测探	cetj
测温	cewf
侧线	cexm
侧向	cexl
测序	cexu
册页	ceye
侧泳	ceys
侧枝	cevi
侧柱	cevu
侧足	cezu
参错	cfco
岑巩	cfgs
岑寂	cfji
岑溪	cfxi
层报	cgbc
蹭蹬	cgdg
曾咀	cgju
层林	cglb
层流	cglq
层峦	cglr
层析	cgxi
层压	cgya
层云	cgyy
查摆	iabd
茶场	iaih
叉车	iaie
茶炊	iaiv
查档	iadh
茶碟	iadp
插兜	iadz
茶会	iahv
插脚	iajn
查究	iajq
岔开	iakk
茶客	iake
茶陵	ialk
茶农	ians
茶盘	iapj
查铺	iapu
查勤	iaqb
茶色	iase
茶社	iaue
插身	iauf
差生	iaug
插硕	iauo
插穗	iasv
茶摊	iatj
茶汤	iath
查特	iate
查体	iati
插条	iatn
茶亭	iatk
茶托	iato
差误	iawu
茶锈	iaxq
察雅	iaya
差音	iayb
茶油	iayz
插针	iavf
插值	iavi
茶砖	iavr
茶庄	iavl
茶桌	iavo
侪辈	idbw
拆兑	iddv
柴垛	iddz
柴扉	idfw
拆改	idgd
豺狗	idgz
柴光	idgl
柴禾	idhe
柴胡	idhu
拆换	idhr
柴黄	idhl
拆开	idkk
柴连	idlm
拆零	idlk
拆卖	idmd
柴门	idmf
柴米	idmi
柴棚	idpg
拆墙	idql
柴芩	idqb
柴酮	idts
钗湾	idwj
差役	idyi
柴银	idyb
缠绑	ijbh
铲车	ijie
产程	ijig
产道	ijdc
搀兑	ijdv
产儿	ijer
蟾宫	ijgs
蟾光	ijgl
谗害	ijhd
廛河	ijhe
产经	ijjk
禅林	ijlb
产灵	ijlk
禅门	ijmf
缠磨	ijmo
谗佞	ijnk
产婆	ijpo
产热	ijre
产伤	ijuh
蟾酥	ijsu
产泰	ijtd
禅堂	ijth
馋涎	ijxm
禅学	ijxt
阐扬	ijyh
缠腰	ijyc
颤悠	ijyz
产仔	ijzd
禅宗	ijzs
肠癌	ihai
长白	ihbd
倡办	ihbj
畅邦	ihbh
唱本	ihbf
长编	ihbm
长别	ihbp
长波	ihbo
厂部	ihbu
长策	ihce
敞车	ihie
长齿	ihii
长虫	ihis
常德	ihde
唱碟	ihdp
长耳	iher
长丰	ihfg
长庚	ihgg
长海	ihhd
长号	ihhc
怅恨	ihhf
常衡	ihhg
长话	ihhx
畅怀	ihhk
常会	ihhv
长活	ihho
长脚	ihjn
肠康	ihkh
长款	ihkr
场栏	ihlj
长堎	ihlg
敞露	ihlu
场论	ihly
长蛮	ihmj
畅美	ihmw
长门	ihmf
唱盘	ihpj
场频	ihpb
昌平	ihpk
菖蒲	ihpu
长桥	ihqn
昌邱	ihqq
常水	ihuv
长松	ihss
长随	ihsv
场体	ihti
长天	ihtm
唱头	ihtz
怅惋	ihwj
厂休	ihxq
常压	ihya
畅泽	ihze
长爪	ihvc
唱针	ihvf
常州	ihvz
潮安	ican
超拔	icba
抄查	icia
超产	icij
朝臣	icif
朝城	icig
超雌	icci
超等	icdg
朝顶	icdk
炒肝	icgj
炒更	icgg
朝贡	icgs
超荷	iche
朝觐	icjb
超类	iclw
超量	icll
超滤	iclv
抄没	icmo
超能	icng
吵扰	icrc
潮润	icry
朝山	icuj
炒勺	icuc
抄身	icuf
超肽	ictd
朝啼	icti
潮头	ictz
潮位	icww
超我	icwo
超雄	icxs
超绚	icxr
超压	icya
超逸	icyi
超卓	icvo
超子	iczi
车把	ieba
车版	iebj
撤编	iebm
车带	iedd
撤防	iefg
撤岗	iegh
车工	iegs
车购	iegz
车行	iehh
扯谎	iehl
车缙	iejb
车蜡	iela
车铃	ielk
车模	iemo
车奴	ienu
车旗	ieqi
车圈	ieqr
车容	iers
车锁	ieso
车条	ietn
车长	ievh
车照	ievc
车辙	ieve
车组	iezu
趁便	ifbm
陈兵	ifbk
衬布	ifbu
晨炊	ifiv
陈词	ifci
陈埭	ifdd
尘毒	ifdu
尘肺	iffw
尘垢	ifgz
沉痼	ifgu
沉酣	ifhj
陈浩	ifhc
衬肩	ifjm
沉降	ifjl
尘芥	ifjp
晨骏	ifjy
辰兰	iflj
沉雷	iflw
陈粮	ifll
衬领	iflk
沉落	iflo
沉埋	ifmd
嗔怒	ifnu
沉潜	ifqm
辰砂	ifua
陈绍	ifuc
称身	ifuf
陈套	iftc
称体	ifti
辰旺	ifwh
谶纬	ifww
臣下	ifxx
尘嚣	ifxn
沉雄	ifxs
沉勇	ifys
辰泽	ifze
郴州	ifvz
成安	igan
城步	igbu
成册	igce
程差	igia
澄城	igig
成虫	igis
称贷	igdd
承德	igde
城雕	igdn
城东	igds
成风	igfg
撑篙	iggc
城根	iggf
城固	iggu
承光	iggl
成规	iggv
澄海	ighd
程函	ighj
骋怀	ighk
承筋	igjb
撑开	igkk
城口	igkz
成殓	iglm
承灵	iglk
柽柳	iglq
城楼	iglz
呈露	iglu
澄迈	igmd
称美	igmw
城南	ignj
秤盘	igpj
承平	igpk
诚朴	igpu
成日	igri
诚瑞	igrv
撑伞	igsj
成俗	igsu
成算	igsr
称叹	igtj
城铁	igtp
成万	igwj
成宿	igxq
成夜	igye
城战	igvj
承转	igvr
赤背	iibw
赤潮	iiic
赤忱	iiif
赤胆	iidj
赤地	iidi
赤豆	iidz
斥革	iige
赤恭	iigs
痴话	iihx
赤坎	iikj
赤狼	iilh
赤炼	iilm
吃粮	iill
炽烈	iilp
赤鳞	iilb
哧溜	iilq
赤龙	iils
赤露	iilu
齿蛮	iimj
魑魅	iimw
赤门	iimf
迟萌	iimg
持球	iiqq
驰驱	iiqu
赤日	iiri
赤色	iise
痴傻	iiua
赤芍	iiuc
炽盛	iiug
敕书	iiuu
赤松	iiss
齿髓	iisv
侈谈	iitj
炽天	iitm
斥退	iitv
赤霞	iixx
持械	iixp
笞刑	iixk
迟牙	iiya
齿龈	iiyb
池沼	iivc
痴醉	iizv
池座	iizo
崇安	isan
冲茶	isia
虫巢	isic
重衬	isif
冲程	isig
冲床	isil
冲顶	isdk
重读	isdu
重发	isfa
重钢	isgh
充公	isgs
宠惯	isgr
重光	isgl
虫害	ishd
冲唬	ishu
冲花	ishx
虫胶	isjn
重九	isjq
冲决	isjt
冲开	iskk
冲扩	isko
冲烈	islp
重楼	islz
冲门	ismf
舂米	ismi
充能	isng
重排	ispd
虫群	isqy
冲塌	ista
重弹	istj
重头	istz
重选	isxr
冲要	isyc
宠用	isys
重游	isyz
重圆	isyr
冲澡	iszc
崇州	isvz
重铸	isvu
酬报	izbc
抽测	izce
臭椿	iziy
绸带	izdd
抽斗	izdz
酬对	izdv
臭蒿	izhc
酬和	izhe
稠糊	izhu
抽换	izhr
丑剧	izju
抽考	izkc
俦侣	izlv
丑奴	iznu
抽搦	izno
筹拍	izpd
抽球	izqq
抽入	izru
筹商	izuh
抽速	izsu
筹算	izsr
抽穗	izsv
抽缩	izso
抽头	iztz
臭腺	izxm
抽选	izxr
抽芽	izya
抽绎	izyi
抽印	izyb
酬应	izyk
臭鼬	izyz
瞅着	izve
筹组	izzu
酬酢	izzo
出榜	iubh
出胞	iubc
除弊	iubi
触变	iubm
初春	iuiy
初腭	iuee
雏凤	iufg
除根	iugf
出航	iuhh
初会	iuhv
初婚	iuhy
储君	iujy
除开	iukk
出科	iuke
初亏	iukv
出栏	iulj
初六	iulq
出苗	iumn
初民	iumb
储能	iung
厨娘	iunl
雏鸟	iunn
搐搦	iuno
出盘	iupj
出圃	iupu
初晴	iuqk
刍荛	iurc
触杀	iuua
初霜	iuul
初速	iusu
黜退	iutv
出脱	iuto
初小	iuxn
出血	iuxp
初心	iuxb
楚雄	iuxs
出洋	iuyh
出迎	iuyk
储运	iuyy
出蛰	iuve
揣度	ikdz
揣想	ikxl
搋子	ikzi
传本	irbf
舛错	irco
传电	irdm
舛讹	iree
船帆	irfj
传粉	irff
传感	irgj
传告	irgc
船歌	irge
传观	irgr
氚核	irhe
川红	irhs
川黄	irhl
川汇	irhv
传戒	irjp
传经	irjk
川军	irjy
穿孔	irks
传流	irlq
川龙	irls
川马	irma
船民	irmb
传名	irmk
船篷	irpg
船钱	irqm
串亲	irqb
传球	irqq
串扰	irrc
川沙	irua
穿水	iruv
穿堂	irth
船体	irti
船艇	irtk
传信	irxb
川芎	irxs
船营	iryk
串游	iryz
传语	iryu
传赞	irzj
穿凿	irzc
船闸	irva
传种	irvs
创成	ilig
窗洞	ilds
窗花	ilhx
窗棂	illk
窗幔	ilmj
窗门	ilmf
窗纱	ilua
窗扇	iluj
创税	iluv
疮疡	ilyh
创灼	ilvo
垂耳	iver
垂范	ivfj
垂拱	ivgs
锤骨	ivgu
垂挂	ivgx
吹管	ivgr
吹号	ivhc
垂老	ivlc
垂落	ivlo
吹拍	ivpd
垂肉	ivrz
吹台	ivtd
吹弹	ivtj
垂髫	ivtn
垂问	ivwf
垂悬	ivxr
炊帚	ivvz
淳安	iyan
春饼	iybk
春播	iybo
春茶	iyia
春城	iyig
春初	iyiu
蠢蠢	iyiy
唇挡	iydh
纯迪	iydi
蠢动	iyds
春肥	iyfw
唇杆	iygj
纯钢	iygh
春灌	iygr
醇和	iyhe
纯黑	iyhw
春荒	iyhl
春假	iyjx
春困	iyky
醇醪	iylc
纯良	iyll
唇裂	iylp
春令	iylk
春麦	iymd
春牛	iynq
椿皮	iypi
纯品	iypb
纯然	iyrj
春日	iyri
春山	iyuj
春上	iyuh
醇酸	iysr
纯态	iytd
纯网	iywh
春闱	iyww
唇吻	iywf
椿萱	iyxr
春雪	iyxt
春汛	iyxy
唇缘	iyyr
辍笔	izbi
戳穿	izir
戳儿	izer
戳破	izpo
绰约	izyt
糍粑	ciba
刺柏	cibd
磁暴	cibc
磁变	cibm
磁层	cicg
磁畴	ciiz
磁的	cide
次等	cidg
磁碟	cidp
次腭	ciee
词法	cifa
词干	cigj
词根	cigf
辞官	cigr
慈航	cihh
刺槐	cihk
雌黄	cihl
次货	ciho
磁卡	cika
磁扣	cikz
刺啦	cila
磁链	cilm
磁漏	cilz
刺马	cima
词盲	cimh
刺毛	cimc
刺梅	cimw
磁面	cimm
祠庙	cimn
磁膜	cimo
磁能	cing
词牌	cipd
磁泡	cipc
刺配	cipw
刺皮	cipi
词谱	cipu
刺球	ciqq
辞却	ciqt
辞让	cirh
磁扰	circ
雌蕊	cirv
辞色	cise
词素	cisu
辞岁	cisv
刺藤	citg
疵瑕	cixx
磁县	cixm
磁学	cixt
刺痒	ciyh
次站	civj
磁轴	civz
刺鬃	cizs
葱翠	cscv
丛菔	csfu
丛集	csji
从教	csjn
丛刊	cskj
丛刻	cske
从快	cskk
葱莲	cslm
葱茏	csls
从轮	csly
丛密	csmi
从母	csmu
从那	csna
从南	csnj
从内	csnw
从你	csni
从盘	cspj
从旁	csph
从权	csqr
从人	csrf
丛山	csuj
从上	csuh
葱蒜	cssr
从他	csta
丛台	cstd
丛谈	cstj
从外	cswd
从我	cswo
从西	csxi
从先	csxm
从新	csxb
从刑	csxk
葱郁	csyu
丛原	csyr
丛杂	csza
丛葬	cszh
从站	csvj
从这	csve
从左	cszo
凑成	czig
凑出	cziu
凑对	czdv
凑个	czge
凑集	czji
凑了	czle
腠理	czli
凑拢	czls
凑乱	czlr
凑趣	czqu
凑上	czuh
凑手	czuz
凑兴	czxk
促产	cuij
粗的	cude
粗短	cudr
蹙额	cuee
粗钢	cugh
粗估	cugu
粗豪	cuhc
粗黑	cuhw
粗厚	cuhz
粗糠	cukh
粗坑	cukg
粗狂	cukl
粗拉	cula
醋栗	culi
醋溜	culq
粗陋	culz
促脉	cumd
粗莽	cumh
粗毛	cumc
粗米	cumi
粗木	cumu
粗女	cunv
粗胖	cuph
粗朴	cupu
促请	cuqk
粗涩	cuse
簇射	cuue
促退	cutv
促狭	cuxx
殂谢	cuxp
粗选	cuxr
粗哑	cuya
粗盐	cuyj
醋意	cuyi
粗硬	cuyk
促织	cuvi
粗拙	cuvo
篡党	crdh
攒动	crds
攒盒	crhe
窜红	crhs
攒聚	crju
攒眉	crmw
撺弄	crns
窜跑	crpc
窜扰	crrc
攒射	crue
窜升	crug
汆汤	crth
窜网	crwh
攒竹	crvu
脆饼	cvbk
崔波	cvbo
翠翠	cvcv
脆的	cvde
催动	cvds
催发	cvfa
催肥	cvfw
翠蚨	cvfu
催告	cvgc
催耕	cvgg
崔颢	cvhc
催还	cvhr
淬火	cvho
崔家	cvjx
崔健	cvjm
催缴	cvjn
翠蓝	cvlj
脆亮	cvll
翠峦	cvlr
催马	cvma
毳毛	cvmc
崔娜	cvna
催奶	cvnd
脆嫩	cvnf
翠鸟	cvnn
脆皮	cvpi
翠屏	cvpk
催迫	cvpo
催情	cvqk
催乳	cvru
翠色	cvse
催熟	cvuu
脆爽	cvul
催他	cvta
催汤	cvth
催讨	cvtc
催吐	cvtu
翠湾	cvwj
萃仙	cvxm
脆性	cvxk
催芽	cvya
翠叶	cvye
翠园	cvyr
脆枣	cvzc
催着	cvve
催征	cvvg
催租	cvzu
存案	cyan
村霸	cyba
村边	cybm
存查	cyia
寸长	cyih
存车	cyie
村村	cycy
存底	cydi
寸断	cydr
村队	cydv
忖度	cydz
皴法	cyfa
存放	cyfg
寸功	cygs
村规	cygv
存户	cyhu
村居	cyju
寸楷	cykk
寸刻	cyke
存栏	cylj
存了	cyle
皴裂	cylp
寸芒	cymh
村名	cymk
存殁	cymo
村内	cynw
存念	cynm
村女	cynv
存期	cyqi
村人	cyrf
村容	cyrs
村上	cyuh
存水	cyuv
村俗	cysu
寸铁	cytp
寸土	cytu
村屯	cyty
村外	cywd
村务	cywu
存息	cyxi
存下	cyxx
存项	cyxl
寸阴	cyyb
存有	cyyz
存于	cyyu
存照	cyvc
存执	cyvi
村中	cyvs
存贮	cyvu
村组	cyzu
错把	coba
错编	cobm
错车	coie
搓搓	coco
措大	coda
错待	codd
错的	code
蹉跌	codp
错动	cods
错读	codu
错分	coff
错告	cogc
错号	cohc
错会	cohv
撮箕	coji
错将	cojl
错金	cojb
错开	cokk
错流	colq
错路	colu
错落	colo
措美	comw
错谬	comq
错那	cona
痤宁	conk
错配	copw
措勤	coqb
挫锐	corv
挫损	cosy
错填	cotm
错退	cotv
错写	coxp
撮要	coyc
措意	coyi
错杂	coza
措置	covi
错综	cozs
大澳	daao
大别	dabp
大菜	dacd
大仓	dach
打草	dacc
打柴	daid
打禅	daij
大疮	dail
大锤	daiv
大村	dacy
大袋	dadd
达尔	daer
大干	dagj
打更	dagg
打鬼	dagv
大哈	daha
打夯	dahh
大黑	dahw
大很	dahf
大坑	dakg
打烂	dalj
大料	daln
大溜	dalq
大龙	dals
达伦	daly
大毛	damc
大梦	damg
大面	damm
大庙	damn
大谬	damq
大木	damu
大拿	dana
大呢	dane
大能	dang
大鸟	dann
达诺	dano
大女	danv
大钱	daqm
大且	daqp
大秦	daqb
大群	daqy
大热	dare
达日	dari
大肉	darz
大阮	darr
大韶	dauc
达爽	daul
大顺	dauy
大所	daso
打他	data
达特	date
大田	datm
大跳	datn
大团	datr
大屯	daty
大洼	dawa
大新	daxb
大凶	daxs
大汛	daxy
大赞	dazj
大藏	dazh
大则	daze
大政	davg
大抓	davx
大椎	davv
戴奥	ddao
代偿	ddih
带大	ddda
骀荡	dddh
怠惰	dddz
待发	ddfa
待岗	ddgh
带过	ddgo
代还	ddhd
代宏	ddhs
带坏	ddhk
待婚	ddhy
待建	ddjm
带锯	ddju
待决	ddjt
带菌	ddjy
代开	ddkk
待考	ddkc
戴拉	ddla
黛蓝	ddlj
带累	ddlw
呆愣	ddlg
带练	ddlm
戴林	ddlb
黛绿	ddlv
带脉	ddmd
带面	ddmm
袋内	ddnw
带你	ddni
代宁	ddnk
代培	ddpw
待聘	ddpb
带谱	ddpu
带挈	ddqp
戴娆	ddrc
岱山	dduj
带他	ddta
带同	ddts
带团	ddtr
带往	ddwh
带我	ddwo
代县	ddxm
大原	ddyr
岱岳	ddyt
待诏	ddvc
袋中	ddvs
丹奥	djao
单瓣	djbj
单帮	djbh
但比	djbi
单边	djbm
丹鳖	djbp
但不	djbu
淡菜	djcd
单侧	djce
单层	djcg
单产	djij
但从	djcs
丹迪	djdi
单点	djdm
单碟	djdp
但都	djdz
单端	djdr
但对	djdv
丹顿	djdy
丹恩	djen
单发	djfa
丹佛	djfo
但该	djgd
弹弓	djgs
胆管	djgr
但还	djhd
单交	djjn
但就	djjq
但均	djjy
但看	djkj
单靠	djkc
弹坑	djkg
单裤	djku
但亏	djkv
胆乐	djle
丹棱	djlg
淡绿	djlv
但马	djma
但没	djmw
单门	djmf
单面	djmm
氮萘	djnd
丹皮	djpi
蛋品	djpb
单枪	djql
但仍	djrg
丹瑞	djrv
单设	djue
单双	djul
单说	djuo
单丝	djsi
胆酸	djsr
但随	djsv
但所	djso
单态	djtd
单瘫	djtj
单糖	djth
丹桃	djtc
但听	djtk
丹徒	djtu
但我	djwo
淡血	djxt
但应	djyk
单用	djys
但在	djzd
丹泽	djze
但这	djve
丹贞	djvf
单证	djvg
但总	djzs
党报	dhbc
当恩	dhen
党法	dhfa
挡寒	dhhj
当街	dhjp
党刊	dhkj
党课	dhke
当空	dhks
党魁	dhkv
党龄	dhlk
谠论	dhly
当卖	dhmd
当票	dhpn
党旗	dhqi
党群	dhqy
砀山	dhuj
党参	dhuf
当堂	dhth
党团	dhtr
党项	dhxl
党性	dhxk
当雄	dhxs
凼仔	dhzd
当值	dhvi
荡舟	dhvz
导报	dcbc
导标	dcbn
倒彩	dccd
倒仓	dcch
稻城	dcig
导赤	dcii
倒垂	dciv
倒带	dcdd
刀豆	dcdz
刀儿	dcer
蹈海	dchd
刀痕	dchf
岛弧	dchu
倒换	dchr
道经	dcjk
盗掘	dcjt
稻糠	dckh
导坑	dckg
盗魁	dckv
道口	dckz
叨唠	dclc
刀林	dclb
道门	dcmf
稻苗	dcmn
导纳	dcna
导尿	dcnn
道破	dcpo
道情	dcqk
倒嗓	dcsh
倒算	dcsr
倒锁	dcso
倒坍	dctj
道统	dcts
道外	dcwd
悼亡	dcwh
祷文	dcwf
倒卧	dcwo
倒休	dcxq
捣药	dcyc
倒爷	dcye
倒灶	dczc
道砟	dcva
倒找	dcvc
稻种	dcvs
祷祝	dcvu
倒装	dcvl
德安	dean
德拜	debd
德保	debc
得标	debn
德昌	deih
德都	dedu
德宏	dehs
德货	deho
得劲	dejb
得空	deks
德纳	dena
德尼	deni
德钦	deqb
得热	dere
得荣	ders
德森	desf
得数	deuu
德望	dewh
得闲	dexm
德政	devg
德州	devz
得用	dwys
等边	dgbm
灯标	dgbn
邓埠	dgbu
灯彩	dgcd
灯草	dgcc
等差	dgia
登程	dgig
等次	dgci
灯法	dgfa
登封	dgfg
邓公	dggs
镫骨	dggu
灯花	dghx
等角	dgjn
灯节	dgjp
邓肯	dgkf
磴口	dgkz
等量	dgll
瞪羚	dglk
灯捻	dgnm
登攀	dgpj
等偏	dgpm
灯伞	dgsj
等身	dguf
灯头	dgtz
蹬腿	dgtv
等外	dgwd
等温	dgwf
灯影	dgyk
邓州	dgvz
灯座	dgzo
低凹	diao
地波	dibo
地槽	dicc
底册	dice
地秤	diig
滴虫	diis
笛春	diiy
滴翠	dicv
迪恩	dien
迪格	dige
低跟	digf
堤埂	digg
敌害	dihd
地核	dihe
迪红	dihs
底火	diho
低聚	diju
涤卡	dika
地矿	dikl
地蜡	dila
地邻	dilb
迪露	dilu
第卵	dilr
底码	dima
地幔	dimj
迪皿	dimb
地膜	dimo
蒂娜	dina
迪诺	dino
堤坡	dipo
地权	diqr
蒂萨	disa
迪塞	disd
地刷	diux
迪索	diso
敌特	dite
地拖	dito
抵用	diys
敌友	diyz
地照	divc
地政	divg
地轴	divz
骶椎	divv
地租	dizu
点兵	dmbk
电铲	dmij
电的	dmde
点发	dmfa
电感	dmgj
电工	dmgs
电挂	dmgx
电灌	dmgr
电光	dmgl
电耗	dmhc
滇红	dmhs
殿后	dmhz
点卡	dmka
电抗	dmkh
佃客	dmke
电码	dmma
典卖	dmmd
电鳗	dmmj
淀酶	dmmw
电磨	dmmo
电木	dmmu
电纳	dmna
电钮	dmnq
佃农	dmns
颠沛	dmpw
点漂	dmpn
电气	dmqi
垫钱	dmqm
颠茄	dmqp
垫圈	dmqr
点群	dmqy
碘散	dmsj
典沙	dmua
点收	dmuz
电刷	dmux
电文	dmwf
电象	dmxl
电压	dmya
电邀	dmyc
电冶	dmye
电泳	dmys
殿宇	dmyu
电晕	dmyy
电灶	dmzc
典章	dmvh
雕版	dnbj
凋残	dncj
吊打	dnda
调调	dndn
刁恶	dnee
调发	dnfa
调防	dnfg
掉过	dngo
调号	dnhc
刁横	dnhg
凋枯	dnku
吊兰	dnlj
吊链	dnlm
吊盘	dnpj
吊铺	dnpu
吊桥	dnqn
吊球	dnqq
掉色	dnud
吊索	dnso
吊塔	dnta
吊梯	dnti
吊桶	dnts
凋萎	dnww
调运	dnyy
雕凿	dnzc
吊装	dnvl
蝶鞍	dpan
迭部	dpbu
叠彩	dpcd
迭出	dpiu
迭次	dpci
叠翠	dpcv
叠氮	dpdj
蝶精	dpjk
蝶兰	dplj
迭力	dpli
迭连	dplm
迭起	dpqi
蝶山	dpuj
跌水	dpuv
蹀躞	dpxp
蝶形	dpxk
叠印	dpyb
叠韵	dpyy
叠嶂	dpvh
跌坐	dpzo
丁坝	dkba
定本	dkbf
定产	dkij
鼎城	dkig
定喘	dkir
钉锤	dkiv
丁醇	dkiy
顶灯	dkdg
鼎鼎	dkdk
顶盖	dkgd
定更	dkgg
顶骨	dkgu
定海	dkhd
顶好	dkhc
丁缓	dkhr
定结	dkjp
定睛	dkjk
丁克	dkke
定坤	dkky
顶楼	dklz
钉螺	dklo
钉帽	dkmc
定苗	dkmn
丁那	dkna
顶牛	dknq
钉耙	dkpa
定钱	dkqm
钉枪	dkql
顶球	dkqq
丁炔	dkqt
定日	dkri
定说	dkuo
丁酸	dksr
定陶	dktc
顶头	dktz
顶突	dktu
丁烷	dkwj
定销	dkxn
定眩	dkxr
顶叶	dkye
定音	dkyb
定影	dkyk
丁忧	dkyz
定则	dkze
顶账	dkvh
定中	dkvs
定州	dkvz
定准	dkvy
丢官	dqgr
丢却	dqqt
丢置	dqvi
东安	dsan
冬菜	dscd
东侧	dsce
东昌	dsih
东城	dsig
洞达	dsda
东单	dsdj
东道	dsdc
动电	dsdm
东阿	dsee
东港	dsgh
冬耕	dsgg
东沟	dsgz
东光	dsgl
冬烘	dshs
东湖	dshu
动换	dshr
动火	dsho
洞见	dsjm
冻僵	dsjl
东郊	dsjn
东晋	dsjb
动觉	dsjt
洞开	dskk
东莱	dsld
东兰	dslj
冬狼	dslh
东辽	dsln
动毛	dsmc
冬末	dsmo
冬娜	dsna
冻馁	dsnw
冬鸟	dsnn
东宁	dsnk
冬皮	dspi
动迁	dsqm
东墙	dsql
东桥	dsqn
东区	dsqu
冬泉	dsqr
冻肉	dsrz
东旺	dswh
东魏	dsww
动问	dswf
动窝	dswo
冬闲	dsxm
东修	dsxq
冻灾	dszd
动真	dsvf
冬贮	dsvu
洞子	dszi
都安	dzan
豆包	dzbc
豆饼	dzbk
抖颤	dzij
兜抄	dzic
斗车	dzie
痘疮	dzil
逗点	dzdm
兜翻	dzfj
斗拱	dzgs
豆秸	dzjp
陡峻	dzjy
豆绿	dzlv
兜帽	dzmc
斗门	dzmf
豆面	dzmm
兜鍪	dzmz
逗弄	dzns
豆皮	dzpi
豆青	dzqk
豆蓉	dzrs
豆乳	dzru
豆薯	dzuu
豆汤	dzth
豆婷	dztk
豆渣	dzva
窦周	dzvz
杜安	duan
度标	dubn
镀层	ducg
度牒	dudp
肚兜	dudz
杜恩	duen
毒饵	duer
杜菲	dufw
赌风	dufg
杜甘	dugj
督工	dugs
杜汉	duhj
独角	dujn
读经	dujk
读框	dukl
杜隆	duls
髑髅	dulz
嘟噜	dulu
杜马	duma
度命	dumk
毒谋	dumz
镀镍	dunp
独女	dunv
读破	dupo
渡桥	duqn
赌情	duqk
毒殇	duuh
督率	duuk
读锁	duso
渡头	dutz
毒蕈	duxy
独一	duyi
督俞	duyu
独院	duyr
督阵	duvf
断背	drbw
段表	drbn
断潮	dric
断齿	drii
短传	drir
断代	drdd
端方	drfg
断骨	drgu
断喝	drhe
断乎	drhu
断脊	drji
断筋	drjb
断开	drkk
断垄	drls
端木	drmu
端脑	drnc
端钮	drnq
端袢	drpj
断飘	drpn
短枪	drql
断乳	drru
短衫	druj
段锁	drso
锻铁	drtp
短腿	drtv
端绪	drxu
端阳	dryh
端由	dryz
断岳	dryt
断种	drvs
端州	drvz
对本	dvbf
对裁	dvcd
堆存	dvcy
兑端	dvdr
堆垛	dvdz
堆肥	dvfw
对攻	dvgs
对光	dvgl
对过	dvgo
队徽	dvhv
对火	dvho
对开	dvkk
兑款	dvkr
对零	dvlk
对能	dvng
对亲	dvqb
兑取	dvqu
队日	dvri
对酌	dvvo
蹲班	dybj
钝鼻	dybi
趸船	dyir
盾反	dyfj
盾盖	dygd
钝剑	dyjm
顿克	dyke
趸批	dypi
盾片	dypm
敦聘	dypb
盾墙	dyql
敦请	dyqk
钝伤	dyuh
顿首	dyuz
钝痛	dyts
钝响	dyxl
顿消	dyxn
夺杯	dzbw
夺标	dzbn
多播	dzbo
多彩	dzcd
躲藏	dzch
多重	dzis
多次	dzci
夺得	dzde
多端	dzdr
多恩	dzen
剁骨	dzgu
多寡	dzgx
夺冠	dzgr
多核	dzhe
多晶	dzjk
多久	dzjq
多兰	dzlj
多林	dzlb
多龙	dzls
堕马	dzma
多么	dzme
夺目	dzmu
多年	dznm
躲让	dzrh
多日	dzri
剁肉	dzrz
躲闪	dzuj
多少	dzuc
剁碎	dzsv
哆嗦	dzso
多头	dztz
多维	dzww
多涎	dzxm
多谢	dzxp
多心	dzxb
多样	dzyh
多云	dzyy
躲债	dzvd
夺占	dzvj
多种	dzvs
腭凹	eeao
鄂城	eeig
恶齿	eeii
谔谔	eeee
俄而	eeer
饿饭	eefj
阿附	eefu
鹅根	eegf
额骨	eegu
鹅湖	eehu
蛾苓	eelk
扼流	eelq
恶露	eelu
腭面	eemm
额敏	eemb
讹谬	eemq
厄难	eenj
呃逆	eeni
恶念	eenm
萼片	eepm
饿殍	eepn
恶气	eeqi
俄顷	eeqk
恶人	eerf
鹅绒	eers
峨山	eeuj
恶少	eeuc
恶声	eeug
额数	eeuu
恶水	eeuv
讹脱	eeto
讹误	eewu
腭腺	eexm
恶枭	eexn
鹅血	eext
额叶	eeye
噩兆	eevc
恶浊	eevo
噁唑	eezo
恩城	enig
恩宠	enis
恩平	enpk
恩通	ents
恩炀	enyh
恩尤	enyz
二板	erbj
儿宝	erbc
尔曹	ercc
儿茶	eria
二重	eris
二醇	eriy
二道	erdc
耳点	erdm
二冬	erds
耳朵	erdz
尔耳	erer
二反	erfj
耳风	erfg
耳垢	ergz
耳鼓	ergu
耳管	ergr
二黄	erhl
耳甲	erjx
儿康	erkh
而况	erkl
耳廓	erko
儿郎	erlh
二老	erlc
儿马	erma
二毛	ermc
耳门	ermf
二妙	ermn
儿男	ernj
二炮	erpc
耳屏	erpk
贰千	erqm
耳散	ersj
耳生	erug
二水	eruv
耳顺	eruy
二胎	ertd
贰万	erwj
耳蜗	erwo
耳癣	erxr
耳穴	erxt
耳音	eryb
耳针	ervf
二至	ervi
二中	ervs
耳舟	ervz
法奥	faao
法币	fabi
发辫	fabm
发潮	faic
发车	faie
发痴	faii
发端	fadr
法尔	faer
发凡	fafj
发绀	fagj
发箍	fagu
发横	fahg
法剑	fajm
发窘	fajs
发卡	faka
发刊	fakj
法抗	fakh
法雷	falw
法链	falm
法林	falb
法隆	fals
发毛	famc
发面	famm
法能	fang
发蔫	fanm
发排	fapd
法袍	fapc
法权	faqr
发丧	fash
发傻	faua
法伤	fauh
法身	fauf
发套	fatc
法统	fats
阀阅	fayt
法阵	favf
反霸	fjba
梵呗	fjbd
反侧	fjce
反冲	fjis
反带	fjdd
翻斗	fjdz
范恩	fjen
翻耕	fjgg
反顾	fjgu
泛函	fjhj
番红	fjhs
犯浑	fjhy
翻浆	fjjl
番椒	fjjn
犯禁	fjjb
犯境	fjjk
翻开	fjkk
反口	fjkz
反拉	fjla
凡林	fjlb
翻领	fjlk
反流	fjlq
泛论	fjly
反码	fjma
凡命	fjmk
饭囊	fjnh
翻弄	fjns
翻皮	fjpi
泛起	fjqi
繁缛	fjru
翻晒	fjud
犯上	fjuh
泛酸	fjsr
樊西	fjxi
反咬	fjyc
反坐	fjzo
方案	fgan
仿办	fgbj
坊本	fgbf
防病	fgbk
房舱	fgch
方尺	fgii
纺绸	fgiz
放贷	fgdd
放荡	fgdh
防盗	fgdc
方德	fgde
方凳	fgdg
放刁	fgdn
方盾	fgdy
方法	fgfa
房改	fggd
方根	fggf
放工	fggs
放过	fggo
妨害	fghd
防洪	fghs
防护	fghu
放怀	fghk
访旧	fgjq
放开	fgkk
防涝	fglc
芳邻	fglb
房门	fgmf
放牧	fgmu
芳年	fgnm
放牛	fgnq
放炮	fgpc
放枪	fgql
访求	fgqq
芳容	fgrs
放散	fgsj
仿晒	fgud
放哨	fguc
肪酸	fgsr
访谈	fgtj
方糖	fgth
房帖	fgtp
方筒	fgts
方外	fgwd
仿效	fgxn
防锈	fgxq
方药	fgyc
访友	fgyz
防灾	fgzd
仿造	fgzc
芳泽	fgze
放债	fgvd
防战	fgvj
方舟	fgvz
方砖	fgvr
方桌	fgvo
放纵	fgzs
废材	fwcd
肥差	fwid
飞虫	fwis
飞地	fwdi
费恩	fwen
费工	fwgs
腓骨	fwgu
飞狐	fwhu
飞架	fwjx
匪窟	fwku
飞跨	fwkx
肺痨	fwlc
蜚蠊	fwlm
飞流	fwlq
费密	fwmi
飞秒	fwmn
非命	fwmk
飞沫	fwmo
费宁	fwnk
飞奴	fwnu
飞蓬	fwpg
飞散	fwsj
妃色	fwse
飞沙	fwua
菲斯	fwsi
费索	fwso
啡肽	fwtd
非特	fwte
肥西	fwxi
费县	fwxm
飞泻	fwxp
肺芽	fwya
肥源	fwyr
飞云	fwyy
飞灾	fwzd
坟包	ffbc
分兵	ffbk
分餐	ffcj
分册	ffce
分层	ffcg
粉蝶	ffdp
酚丁	ffdk
分度	ffdu
份儿	ffer
分果	ffgo
汾河	ffhe
坟火	ffho
分拣	ffjm
酚咖	ffka
纷乐	ffle
粉岭	fflk
粪瘘	fflz
纷纶	ffly
奋袂	ffmw
粪尿	ffnn
分蘖	ffnp
分片	ffpm
分频	ffpb
粉墙	ffql
分群	ffqy
焚日	ffri
分润	ffry
粉沙	ffua
坟山	ffuj
分说	ffuo
焚天	fftm
汾阳	ffyh
分宜	ffyi
分阴	ffyb
坟茔	ffyk
分院	ffyr
粉状	ffvl
风泵	fgbg
风餐	fgcj
奉达	fgda
凤蝶	fgdp
风斗	fgdz
封二	fger
蜂房	fgfg
封疆	fgjl
蜂胶	fgjn
奉节	fgjp
锋克	fgke
蜂蜡	fgla
枫蓼	fgln
丰隆	fgls
峰峦	fglr
丰南	fgnj
风能	fgng
丰宁	fgnk
蜂农	fgns
风怒	fgnu
风琴	fgqb
缝穷	fgqs
锋锐	fgrv
风色	fgse
风蛇	fgue
丰顺	fguy
风团	fgtr
奉托	fgto
风物	fgwu
奉新	fgxb
风源	fgyr
缝缀	fgvv
风钻	fgzr
封嘴	fgzv
佛灯	fodg
佛迪	fodi
佛冈	fogh
佛骨	fogu
佛号	fohc
佛老	folc
佛坪	fopk
佛器	foqi
佛事	foui
佛手	fouz
佛塔	fota
佛陀	foto
佛牙	foya
否找	fzvc
伏辩	fubm
复波	fubo
浮财	fucd
弗彻	fuie
富川	fuir
斧锤	fuiv
复春	fuiy
浮厝	fuco
浮荡	fudh
腐恶	fuee
弗恩	fuen
复方	fufg
伏根	fugf
扶沟	fugz
辐光	fugl
福海	fuhd
复航	fuhh
抚弘	fuhs
府库	fuku
富矿	fukl
肤廓	fuko
负累	fulw
腹裂	fulp
弗隆	fuls
孵卵	fulr
弗伦	fuly
复洛	fulo
服满	fumj
复萌	fumg
扶苗	fumn
富民	fumb
辅能	fung
俯念	funm
浮漂	fupn
负屈	fuqu
芙瑞	furv
扶弱	furo
伏萨	fusa
扶绥	fusv
夫坦	futj
辐条	futn
付托	futo
覆亡	fuwh
伏汛	fuxy
覆辙	fuve
复诊	fuvf
复转	fuvr
嘎巴	gaba
噶尔	gaer
噶伦	galy
伽师	gaui
嘎子	gazi
赅博	gdbo
盖布	gdbu
盖菜	gdcd
改产	gdij
盖德	gdde
改点	gddm
盖饭	gdfj
盖菲	gdfw
盖衡	gdhg
改刊	gdkj
盖雷	gdlw
盖帘	gdlm
盖曼	gdmj
钙酶	gdmw
盖柠	gdnk
盖诺	gdno
改频	gdpb
该欠	gdqm
改任	gdrf
改色	gdse
盖爽	gdul
概算	gdsr
盖髓	gdsv
盖碗	gdwj
改向	gdxl
改型	gdxk
改选	gdxr
盖亚	gdya
改样	gdyh
改业	gdye
改易	gdyi
盖印	gdyb
改则	gdze
该着	gdvc
改辙	gdve
改种	gdvs
盖州	gdvz
改锥	gdvv
改嘴	gdzv
干安	gjan
干巴	gjba
甘参	gjcj
感迪	gjdi
赶点	gjdm
肝儿	gjer
干肥	gjfw
赶工	gjgs
赶海	gjhd
赶脚	gjjn
干结	gjjp
杆菌	gjjy
干酪	gjlc
肝龙	gjls
甘洛	gjlo
干面	gjmm
甘南	gjnj
感佩	gjpw
干啤	gjpi
干亲	gjqb
干群	gjqy
泔水	gjuv
甘遂	gjsv
肝索	gjso
杆塔	gjta
甘特	gjte
甘为	gjww
甘休	gjxq
擀毡	gjvj
杆状	gjvl
港北	ghbw
港埠	ghbu
钢城	ghig
钢窗	ghil
钢锤	ghiv
钢锭	ghdk
钢盾	ghdy
钢轭	ghee
缸盖	ghgd
刚健	ghjm
钢锯	ghju
钢缆	ghlj
钢梁	ghll
岗楼	ghlz
钢炉	ghlu
岗峦	ghlr
刚毛	ghmc
肛膜	ghmo
纲目	ghmu
港南	ghnj
钢怒	ghnu
缸盆	ghpf
钢坯	ghpi
钢瓶	ghpk
钢钎	ghqm
刚柔	ghrz
钢手	ghuz
岗松	ghss
钢索	ghso
刚体	ghti
钢条	ghtn
缸瓦	ghwa
刚玉	ghyu
钢针	ghvf
钢种	ghvs
钢轴	ghvz
缸砖	ghvr
钢鬃	ghzs
高安	gcan
高爆	gcbc
高倍	gcbw
告便	gcbm
高才	gccd
高淳	gciy
高村	gccy
告贷	gcdd
高顿	gcdy
高恩	gcen
高钙	gcgd
高港	gcgh
高工	gcgs
高光	gcgl
高鹤	gche
膏肓	gchl
高劲	gcjb
高娟	gcjr
告绝	gcjt
告老	gclc
高炉	gclu
高玛	gcma
高慢	gcmj
高门	gcmf
高妙	gcmn
高能	gcng
高炮	gcpc
羔皮	gcpi
高热	gcre
高射	gcue
高爽	gcul
高索	gcso
高塔	gcta
高香	gcxl
高雄	gcxs
膏血	gcxt
高邑	gcyi
稿约	gcyt
高云	gcyy
高燥	gczc
高寨	gcvd
高枕	gcvf
高州	gcvz
隔板	gebj
葛蒡	gebh
葛布	gebu
个虫	geis
格挡	gedh
割点	gedm
铬钢	gegh
膈关	gegr
葛花	gehx
歌会	gehv
割胶	gejn
个旧	gejq
蛤壳	geke
葛坑	gekg
虼螂	gelh
阁僚	geln
戈隆	gels
格宁	genk
隔墙	geql
割切	geqp
戈瑞	gerv
格杀	geua
割伤	geuh
铬酸	gesr
割碎	gesv
圪塔	geta
哥台	getd
哥特	gete
葛藤	getg
铬铁	getp
歌王	gewh
割席	gexi
割线	gexm
各异	geyi
膈俞	geyu
阁员	geyr
虼蚤	gezc
葛正	gevg
给定	gwdk
给假	gwjx
给水	gwuv
给位	gwww
跟包	gfbc
根被	gfbw
根菜	gfcd
根插	gfia
根儿	gfer
根河	gfhe
跟脚	gfjn
根究	gfjq
根剌	gfla
根瘤	gflq
根毛	gfmc
根霉	gfmw
根宁	gfnk
跟拍	gfpd
跟平	gfpk
根鞘	gfqn
跟梢	gfuc
根托	gfto
根围	gfww
根系	gfxi
根须	gfxu
根压	gfya
根株	gfvu
根罪	gfzv
羹匙	ggii
耕畜	ggiu
庚醇	ggiy
更次	ggci
更定	ggdk
更动	ggds
耕读	ggdu
更番	ggfj
耿耿	gggg
耿马	ggma
耕牛	ggnq
更其	ggqi
庚日	ggri
更生	ggug
更舒	gguu
庚酸	ggsr
庚帖	ggtp
庚酮	ggts
更香	ggxl
赓续	ggxu
更张	ggvh
耕者	ggve
公办	gsbj
攻博	gsbo
公差	gsia
公产	gsij
工潮	gsic
供词	gsci
攻错	gsco
工党	gsdh
宫灯	gsdg
宫调	gsdn
公爹	gsdp
拱顶	gsdk
宫斗	gsdz
公吨	gsdy
公法	gsfa
共犯	gsfj
躬耕	gsgg
攻讦	gsjp
公开	gskk
工矿	gskl
宫乐	gsle
攻擂	gslw
巩留	gslq
公论	gsly
巩膜	gsmo
共谋	gsmz
宫宁	gsnk
工农	gsns
弓弩	gsnu
公派	gspd
公判	gspj
工棚	gspg
攻强	gsql
躬亲	gsqb
宫阙	gsqt
拱让	gsrh
供热	gsre
工日	gsri
贡山	gsuj
公诉	gssu
公摊	gstj
工特	gste
工头	gstz
公推	gstv
拱券	gsxr
公演	gsyj
弓腰	gsyc
供者	gsve
共轴	gsvz
公转	gsvr
共总	gszs
苟安	gzan
沟槽	gzcc
钩沉	gzif
钩虫	gzis
购得	gzde
够格	gzge
勾绘	gzhv
枸橘	gzju
购卡	gzka
勾留	gzlq
诟骂	gzma
钩毛	gzmc
勾描	gzmn
勾女	gznv
狗肾	gzuf
钩网	gzwh
够味	gzww
构型	gzxk
沟洫	gzxu
勾乙	gzyi
狗鱼	gzyu
钩爪	gzvc
彀中	gzvs
骨癌	guai
固安	guan
固邦	gubh
古币	gubi
古博	gubo
孤残	gucj
谷草	gucc
估测	guce
估产	guij
固肠	guih
雇车	guie
骨尘	guif
固齿	guii
鼓出	guiu
古纯	guiy
孤村	gucy
骨雕	gudn
骨堆	gudv
骨朵	gudz
骨鲠	gugg
谷红	guhs
骨骺	guhz
骨将	gujl
骨康	gukh
谷口	gukz
骨蜡	gula
古来	guld
谷类	gulw
骨料	guln
古蔺	gulb
骨瘤	gulq
谷米	gumi
顾眄	gumm
谷苗	gumn
牯牛	gunq
骨片	gupm
姑婆	gupo
孤穹	guqs
孤弱	guro
固沙	guua
鼓舌	guue
孤孀	guul
古斯	gusi
古塔	guta
固特	gute
古藤	gutg
固位	guww
故我	guwo
顾绣	guxq
古音	guyb
故宅	guvd
古冢	guvs
古拙	guvo
挂碍	gxai
挂包	gxbc
挂鞭	gxbm
挂表	gxbn
挂车	gxie
卦辞	gxci
呱嗒	gxda
挂带	gxdd
挂灯	gxdg
瓜蒂	gxdi
挂斗	gxdz
刮宫	gxgs
呱呱	gxgx
挂冠	gxgr
寡合	gxhe
挂红	gxhs
寡欢	gxhr
挂火	gxho
挂累	gxlw
挂零	gxlk
寡母	gxmu
瓜农	gxns
瓜棚	gxpg
瓜片	gxpm
挂屏	gxpk
寡情	gxqk
瓜瓤	gxrh
胍生	gxug
刮叔	gxuu
挂锁	gxso
挂毯	gxtj
挂体	gxti
挂图	gxtu
瓜蔓	gxwj
寡味	gxww
寡闻	gxwf
挂鞋	gxxp
瓜秧	gxyh
刮油	gxyz
寡欲	gxyu
挂钟	gxvs
拐棒	gkbh
乖舛	gkir
怪道	gkdc
乖蹇	gkjm
拐角	gkjn
怪杰	gkjp
怪客	gkke
怪论	gkly
乖谬	gkmq
拐子	gkzi
观潮	gric
关冲	gris
灌丛	grcs
冠带	grdd
关东	grds
管段	grdr
观风	grfg
冠沟	grgz
关顾	grgu
棺椁	grgo
管核	grhe
官后	grhz
灌浆	grjl
管井	grjk
棺柩	grjq
管窥	grkv
惯量	grll
关岭	grlk
冠冕	grmm
灌南	grnj
官气	grqi
官桥	grqn
冠沙	grua
关山	gruj
关说	gruo
官塘	grth
馆陶	grtc
惯贼	grzw
惯纵	grzs
管足	grzu
官佐	grzo
广安	glan
光笔	glbi
光灿	glcj
光差	glia
光程	glig
光宠	glis
广德	glde
广丰	glfg
广柑	glgj
广河	glhe
广开	glkk
光刻	glke
光疗	glln
光面	glmm
光敏	glmb
广南	glnj
广宁	glnk
光钮	glnq
光强	glql
光球	glqq
广饶	glrc
光润	glry
广厦	glua
广生	glug
光是	glui
光束	gluu
广水	gluv
光顺	gluy
光瞳	glts
光秃	gltu
广物	glwu
光楔	glxp
光心	glxb
光绪	glxu
光压	glya
光耀	glyc
逛游	glyz
广宇	glyu
广枣	glzc
光闸	glva
广证	glvg
光锥	glvv
广宗	glzs
龟背	gvbw
贵池	gvii
贵穿	gvir
贵德	gvde
桂东	gvds
闺房	gvfg
贵干	gvgj
贵港	gvgh
归航	gvhh
鬼嚎	gvhc
归回	gvhv
鬼将	gvjl
贵南	gvnj
圭臬	gvnp
归宁	gvnk
鬼怒	gvnu
轨炮	gvpc
硅片	gvpm
桂平	gvpk
柜上	gvuh
鬼士	gvui
硅霜	gvul
诡丝	gvsi
鬼祟	gvsv
硅铁	gvtp
硅酮	gvts
鬼王	gvwh
鬼纹	gvwf
贵校	gvxn
归心	gvxb
鬼雄	gvxs
硅油	gvyz
归葬	gvzh
硅藻	gvzc
归总	gvzs
滚存	gycy
滚打	gyda
滚翻	gyfj
滚开	gykk
滚木	gymu
滚刷	gyux
滚压	gyya
辊轴	gyvz
滚珠	gyvu
国本	gobf
锅饼	gobk
果菜	gocd
果茶	goia
过冲	gois
国仇	goiz
过从	gocs
过多	godz
国故	gogu
过孔	goks
锅盔	gokv
过冷	golg
过淋	golb
果洛	golo
果莓	gomw
果农	gons
国丧	gosh
过筛	goud
国殇	gouh
过少	gouc
果穗	gosv
锅台	gotd
国体	goti
过厅	gotk
过夏	goxx
过心	goxb
涡阳	goyh
国乐	goyt
裹扎	goza
过载	gozd
国政	govg
锅庄	govl
裹足	gozu
哈布	habu
哈丁	hadk
哈恩	haen
哈尔	haer
哈格	hage
哈根	hagf
哈金	hajb
哈卡	haka
哈肯	hakf
哈喇	hala
哈兰	halj
哈乐	hale
哈里	hali
哈隆	hals
哈鲁	halu
哈伦	haly
哈蒙	hamg
哈密	hami
哈气	haqi
哈腰	hayc
哈兹	hazi
亥白	hdbd
海北	hdbw
海波	hdbo
海船	hdir
海钓	hddn
海定	hddk
海东	hdds
海鳄	hdee
海匪	hdfw
骇怪	hdgk
海河	hdhe
海魂	hdhy
海角	hdjn
海禁	hdjb
海景	hdjk
海菊	hdju
海康	hdkh
海况	hdkl
海葵	hdkv
海蓝	hdlj
海疗	hdln
海林	hdlb
海流	hdlq
海鳗	hdmj
海门	hdmf
海米	hdmi
害命	hdmk
海宁	hdnk
海怒	hdnu
海派	hdpd
海盆	hdpf
氦气	hdqi
海侵	hdqb
骇然	hdrj
还少	hduc
海蛇	hdue
海曙	hduu
海损	hdsy
海獭	hdta
海特	hdte
海瓦	hdwa
海巫	hdwu
海熊	hdxs
嗨哟	hdyo
海赞	hdzj
海震	hdvf
海州	hdvz
旱魃	hjba
含悲	hjbw
汉滨	hjbb
蔊菜	hjcd
憨痴	hjii
寒促	hjcu
旱稻	hjdc
函调	hjdn
汉恩	hjen
含愤	hjff
寒钢	hjgh
焊工	hjgs
瀚海	hjhd
含恨	hjhf
含混	hjhy
寒噤	hjjb
旱井	hjjk
汉卡	hjka
汗孔	hjks
汉隶	hjli
颔联	hjlm
焊料	hjln
汗漫	hjmj
寒门	hjmf
酣梦	hjmg
酣眠	hjmm
汉民	hjmb
汉娜	hjna
汉南	hjnj
旱年	hjnm
焊盘	hjpj
含片	hjpm
焊钳	hjqm
焊枪	hjql
寒秋	hjqq
寒热	hjre
涵容	hjrs
旱伞	hjsj
寒色	hjse
寒素	hjsu
函索	hjso
汉唐	hjth
焊条	hjtn
寒亭	hjtk
寒腿	hjtv
旱象	hjxl
寒邪	hjxp
含羞	hjxq
寒鸦	hjya
含蕴	hjyy
涵闸	hjva
汗疹	hjvf
寒症	hjvg
韩庄	hjvl
行帮	hhbh
行辈	hhbw
航测	hhce
航船	hhir
行贩	hhfj
夯歌	hhge
航迹	hhji
行间	hhjm
杭锦	hhjb
行款	hhkr
航路	hhlu
航模	hhmo
行频	hhpb
夯砣	hhto
航校	hhxn
沆瀣	hhxp
杭育	hhyo
行员	hhyr
行约	hhyt
蒿本	hcbf
浩博	hcbo
昊迪	hcdi
毫分	hcff
浩海	hchd
豪横	hchg
豪举	hcju
昊康	hckh
好赖	hcld
毫末	hcmo
豪鸟	hcnn
号牌	hcpd
号炮	hcpc
壕堑	hcqm
貉绒	hcrs
耗散	hcsj
豪商	hcuh
豪奢	hcue
号头	hctz
好言	hcyj
皓月	hcyt
毫针	hcvf
郝智	hcvi
豪猪	hcvu
豪壮	hcvl
豪族	hczu
河坝	heba
河蚌	hebh
鹤蟾	heij
盒带	hedd
河东	heds
合度	hedu
河段	hedr
合尔	heer
合该	hegd
核果	hego
荷行	hehh
和会	hehv
合江	hejl
合刊	hekj
核抗	hekh
赫克	heke
核酪	helc
贺联	helm
合量	hell
颌裂	help
核膜	hemo
赫纳	hena
贺年	henm
赫宁	henk
核配	hepw
和洽	heqx
呵欠	heqm
鹤庆	heqk
合手	heuz
和爽	heul
和硕	heuo
贺斯	hesi
核素	hesu
和祥	hexl
喝药	heyc
河源	heyr
河运	heyy
褐藻	hezc
合闸	heva
河鬃	hezs
黑豹	hwbc
黑臂	hwbi
黑貂	hwdn
黑豆	hwdz
黑尔	hwer
黑骨	hwgu
黑光	hwgl
黑河	hwhe
黑红	hwhs
黑货	hwho
黑棘	hwji
黑甲	hwjx
黑箭	hwjm
黑口	hwkz
黑牢	hwlc
黑龙	hwls
黑麦	hwmd
黑面	hwmm
黑魔	hwmo
黑妞	hwnq
黑牌	hwpd
黑泉	hwqr
黑腮	hwsd
黑鼠	hwuu
黑水	hwuv
黑糖	hwth
黑天	hwtm
黑铁	hwtp
黑雾	hwwu
黑锡	hwxi
黑箱	hwxl
黑须	hwxu
黑鸦	hwya
黑窑	hwyc
黑仔	hwzd
黑枣	hwzc
黑账	hwvh
黑爪	hwvc
黑种	hwvs
黑竹	hwvu
黑状	hwvl
黑鬃	hwzs
很多	hfdz
恒奥	hgao
恒邦	hgbh
横暴	hgbc
横比	hgbi
横匾	hgbm
横标	hgbn
横滨	hgbb
横波	hgbo
恒产	hgij
横道	hgdc
恒得	hgde
恒等	hgdg
横笛	hgdi
横断	hgdr
横队	hgdv
横额	hgee
恒恩	hgen
横峰	hgfg
横骨	hggu
横街	hgjp
恒金	hgjb
横空	hgks
横口	hgkz
横列	hglp
横流	hglq
恒迈	hgmd
哼鸣	hgmk
横模	hgmo
衡南	hgnj
横逆	hgni
衡器	hgqi
横桥	hgqn
恒森	hgsf
恒苏	hgsu
亨特	hgte
亨通	hgts
亨威	hgww
横痃	hgxr
恒牙	hgya
恒言	hgyj
横摇	hgyc
恒影	hgyk
哼唷	hgyo
横直	hgvi
横轴	hgvz
亨兹	hgzi
红布	hsbu
荭草	hscc
红场	hsih
红潮	hsic
红刺	hsci
红痱	hsfw
红岗	hsgh
红古	hsgu
红归	hsgv
红果	hsgo
红海	hshd
红河	hshe
洪江	hsjl
红教	hsjn
红角	hsjt
宏块	hskk
宏阔	hsko
洪濑	hsld
鸿烈	hslp
红磷	hslb
红灵	hslk
红楼	hslz
洪炉	hslu
红螺	hslo
红麻	hsma
红盲	hsmh
鸿蒙	hsmg
红棉	hsmm
红庙	hsmn
哄闹	hsnc
哄弄	hsns
红喷	hspf
红桥	hsqn
红区	hsqu
红壤	hsrh
红热	hsre
红砂	hsua
红绳	hsug
红石	hsui
红髓	hssv
红塔	hsta
红亭	hstk
鸿文	hswf
洪武	hswu
红须	hsxu
洪雅	hsya
红药	hsyc
洪泽	hsze
红阵	hsvf
弘正	hsvg
厚薄	hzbc
后舱	hzch
厚唇	hziy
厚赐	hzci
后爹	hzdp
后顶	hzdk
后段	hzdr
猴儿	hzer
候光	hzgl
后汉	hzhj
后颊	hzjx
喉康	hzkh
厚壳	hzke
后梁	hzll
喉裂	hzlp
厚鳞	hzlb
厚膜	hzmo
厚皮	hzpi
后坡	hzpo
厚朴	hzpu
猴拳	hzqr
后厦	hzua
后晌	hzuh
喉舒	hzuu
喉爽	hzul
后送	hzss
后唐	hzth
后屯	hzty
后心	hzxb
后行	hzxk
后学	hzxt
后牙	hzya
喉音	hzyb
后影	hzyk
猴枣	hzzc
喉罩	hzvc
喉症	hzvg
护岸	huan
虎贲	hubf
弧标	hubn
湖滨	hubb
护兵	hubk
湖汊	huia
胡缠	huij
虎刺	huci
互导	hudc
胡豆	hudz
互访	hufg
护工	hugs
胡瓜	hugx
湖怪	hugk
壶关	hugr
呼号	huhc
呼喝	huhe
虎将	hujl
虎劲	hujb
胡库	huku
糊料	huln
呼隆	huls
忽米	humi
护苗	humn
湖盆	hupf
狐皮	hupi
虎钳	huqm
糊墙	huql
胡琴	huqb
互溶	hurs
虎肉	hurz
狐臊	husc
湖色	huse
觳觫	husu
胡荽	husv
湖滩	hutj
湖田	hutm
护腿	hutv
湖屯	huty
滹沱	huto
鹄望	huwh
护胸	huxs
糊药	huyc
虎跃	huyt
湖泽	huze
虎杖	huvh
华安	hxan
华畅	hxih
化虫	hxis
花簇	hxcu
滑道	hxdc
化德	hxde
华迪	hxdi
花缎	hxdr
花朵	hxdz
滑竿	hxgj
花梗	hxgg
华翰	hxhj
滑壳	hxke
桦林	hxlb
花翎	hxlk
滑溜	hxlq
化隆	hxls
花露	hxlu
花苗	hxmn
滑膜	hxmo
华年	hxnm
画派	hxpd
花盘	hxpj
画片	hxpm
花楸	hxqq
化蛇	hxue
花兽	hxuz
滑爽	hxul
花丝	hxsi
花台	hxtd
画帖	hxtp
花王	hxwh
花鞋	hxxp
华约	hxyt
化斋	hxvd
华族	hxzu
淮滨	hkbb
怀德	hkde
槐耳	hker
怀古	hkgu
怀集	hkji
槐角	hkjn
怀来	hkld
怀恋	hklm
淮南	hknj
怀宁	hknk
淮山	hkuj
淮阳	hkyh
怀远	hkyr
环靶	hrba
欢蹦	hrbg
换茬	hria
环衬	hrif
环翠	hrcv
还耕	hrgg
换购	hrgz
换汇	hrhv
还魂	hrhy
环江	hrjl
环礁	hrjn
换进	hrjb
换客	hrke
环列	hrlp
换马	hrma
换毛	hrmc
换名	hrmk
换偶	hrou
缓坡	hrpo
欢洽	hrqx
换亲	hrqb
浣纱	hrua
幻神	hruf
桓台	hrtd
幻天	hrtm
换帖	hrtp
唤头	hrtz
环烷	hrwj
换文	hrwf
环雾	hrwu
换血	hrxp
换药	hryc
环站	hrvj
环中	hrvs
环子	hrzi
磺胺	hlan
黄柏	hlbd
黄饼	hlbk
黄沉	hlif
潢川	hlir
慌促	hlcu
黄的	hlde
黄毒	hldu
皇甫	hlfu
黄冈	hlgh
黄根	hlgf
荒寒	hlhj
黄苦	hlku
黄葵	hlkv
黄蜡	hlla
黄磷	hllb
黄栌	hllu
荒落	hllo
黄麻	hlma
荒蛮	hlmj
肓门	hlmf
黄米	hlmi
黄平	hlpk
荒歉	hlqm
黄青	hlqk
黄壤	hlrh
恍若	hlro
黄升	hlug
磺酸	hlsr
黄藤	hltg
黄体	hlti
皇婷	hltk
黄香	hlxl
蝗灾	hlzd
黄枣	hlzc
黄州	hlvz
回采	hvcd
会操	hvcc
惠存	hvcy
惠迪	hvdi
回跌	hvdp
会儿	hver
灰分	hvff
挥戈	hvge
会攻	hvgs
辉光	hvgl
回空	hvks
回蓝	hvlj
回漏	hvlz
贿买	hvmd
灰猫	hvmc
回门	hvmf
会盟	hvmg
徽墨	hvmo
回目	hvmu
辉南	hvnj
灰泥	hvni
会宁	hvnk
回扫	hvsc
辉腾	hvtg
惠婷	hvtk
回退	hvtv
回销	hvxn
回修	hvxq
灰叶	hvye
灰云	hvyy
会众	hvvs
混充	hyis
珲春	hyiy
婚垫	hydm
混饭	hyfj
混纺	hyfg
婚媾	hygz
魂痕	hyhf
浑江	hyjl
混交	hyjn
荤口	hykz
魂门	hymf
浑朴	hypu
昏阙	hyqt
混色	hyse
混声	hyug
婚书	hyuu
混洗	hyxi
混养	hyyh
荤油	hyyz
魂铸	hyvu
火蚕	hocj
活茬	hoia
霍城	hoig
火炽	hoii
豁出	hoiu
火锤	hoiv
霍地	hodi
活儿	hoer
活法	hofa
伙房	hofg
火攻	hogs
火镰	holm
货流	holq
火芒	homh
火玫	homw
霍姆	homu
火囊	honh
获能	hong
火捻	honm
活宁	honk
和弄	hons
火鹏	hopg
火情	hoqk
火拳	hoqr
火绒	hors
火伤	houh
火神	houf
活爽	houl
祸祟	hosv
货损	hosy
活锁	hoso
活脱	hoto
火网	howh
货位	howw
霍文	howf
火硝	hoxn
火崖	hoya
火印	hoyb
活用	hoys
货栈	hovj
火砖	hovr
火鬃	hozs
基表	jibn
蓟草	jicc
肌醇	jiiy
集粹	jicv
基佛	jifo
纪纲	jigh
机耕	jigg
饥寒	jihj
击昏	jihy
稽考	jikc
基坑	jikg
级控	jiks
激浪	jilh
级联	jilm
棘轮	jily
寂灭	jimp
唧哝	jins
济诺	jino
亟盼	jipj
疾跑	jipc
继配	jipw
讥评	jipk
基沙	jiua
鸡舍	jiue
瘠土	jitu
鸡泽	jize
吉兆	jivc
疾走	jizz
忌嘴	jizv
加巴	jxba
甲苯	jxbf
家传	jxir
甲等	jxdg
架豆	jxdz
加高	jxgc
假根	jxgf
夹棍	jxgy
加翰	jxhj
加衡	jxhg
架环	jxhr
家口	jxkz
家累	jxlw
加料	jxln
假劣	jxlp
加隆	jxls
佳妙	jxmn
荚膜	jxmo
假年	jxnm
佳酿	jxnl
加浓	jxns
加诺	jxno
夹批	jxpi
嘉庆	jxqk
佳蓉	jxrs
嘉瑞	jxrv
贾森	jxsf
甲酸	jxsr
假体	jxti
加添	jxtm
家童	jxts
假托	jxto
甲烷	jxwj
贾汪	jxwh
家兄	jxxs
佳择	jxze
家珍	jxvf
箭靶	jmba
简本	jmbf
坚壁	jmbi
茧绸	jmiz
剪床	jmil
尖脆	jmcv
健存	jmcy
检错	jmco
箭杆	jmgj
肩篌	jmhz
健将	jmjl
肩铠	jmkk
肩宽	jmkr
艰困	jmky
简括	jmko
健朗	jmlh
检疗	jmln
睑裂	jmlp
见林	jmlb
剑灵	jmlk
剑龙	jmls
检录	jmlu
简论	jmly
剑芒	jmmh
间苗	jmmn
简娜	jmna
剑奴	jmnu
践诺	jmno
建瓯	jmou
舰炮	jmpc
毽球	jmqq
间日	jmri
键入	jmru
健润	jmry
健硕	jmuo
茧丝	jmsi
尖酸	jmsr
肩台	jmtd
见天	jmtm
建团	jmtr
肩窝	jmwo
剑侠	jmxx
键序	jmxu
渐晕	jmyy
肩胄	jmvz
江巴	jlba
姜饼	jlbk
疆场	jlih
江潮	jlic
降尘	jlif
奖酬	jliz
江川	jlir
将次	jlci
江达	jlda
姜酊	jldk
豇豆	jldz
江段	jldr
降矾	jlfj
江防	jlfg
姜酚	jlff
江干	jlgj
酱缸	jlgh
降格	jlge
讲古	jlgu
将官	jlgr
江海	jlhd
江汉	jlhj
降耗	jlhc
绛红	jlhs
江淮	jlhk
姜黄	jlhl
姜活	jlho
江口	jlkz
僵冷	jllg
江梁	jlll
浆料	jlln
江流	jllq
江面	jlmm
浆膜	jlmo
江宁	jlnk
奖牌	jlpd
江畔	jlpj
浆泡	jlpc
讲评	jlpk
江浦	jlpu
讲情	jlqk
讲求	jlqq
奖券	jlqr
匠人	jlrf
酱肉	jlrz
酱色	jlse
将帅	jluk
讲说	jluo
僵死	jlsi
江天	jltm
疆土	jltu
江豚	jlty
绛县	jlxm
将校	jlxn
江选	jlxr
江贼	jlzw
降真	jlvf
浇薄	jnbo
绞缠	jnij
焦愁	jniz
胶磁	jnci
角的	jnde
较多	jndz
椒干	jngj
角钢	jngh
绞喉	jnhz
椒江	jnjl
角盔	jnkv
交困	jnky
嚼蜡	jnla
郊狼	jnlh
角楼	jnlz
教民	jnmb
蕉农	jnns
娇女	jnnv
绞盘	jnpj
胶皮	jnpi
角票	jnpn
交迫	jnpo
胶乳	jnru
浇洒	jnsa
焦深	jnuf
角孙	jnsy
脚踏	jnta
角铁	jntp
娇娃	jnwa
教习	jnxi
郊野	jnye
交映	jnyk
交杂	jnza
脚爪	jnvc
胶州	jnvz
角锥	jnvv
桀骜	jpao
接茬	jpia
疥虫	jpis
洁丹	jpdj
杰德	jpde
戒牒	jpdp
结队	jpdv
劫夺	jpdz
解饿	jpee
姐儿	jper
捷根	jpgf
杰卡	jpka
洁康	jpkh
结块	jpkk
杰拉	jpla
街垒	jplw
接邻	jplb
接龙	jpls
洁奈	jpnd
结脑	jpnc
节奴	jpnu
解耦	jpou
接腔	jpql
介壳	jpqn
解劝	jpqr
解热	jpre
杰森	jpsf
界山	jpuj
接穗	jpsv
接榫	jpsy
杰特	jpte
揭帖	jptp
节下	jpxx
介休	jpxq
接续	jpxu
杰勋	jpxy
结症	jpvg
桀纣	jpvz
界桩	jpvl
节宗	jpzs
接嘴	jpzv
锦标	jbbn
进兵	jbbk
今草	jbcc
金川	jbir
金疮	jbil
金粉	jbff
金糕	jbgc
金格	jbge
浸焊	jbhj
禁核	jbhe
金衡	jbhg
金红	jbhs
禁毁	jbhv
禁绝	jbjt
进款	jbkr
锦葵	jbkv
金兰	jblj
劲朗	jblh
锦纶	jbly
金络	jblo
紧忙	jbmh
金盟	jbmg
金鸣	jbmk
金姆	jbmu
津南	jbnj
晋宁	jbnk
金怒	jbnu
金瓯	jbou
近旁	jbph
金盆	jbpf
金票	jbpn
禁品	jbpb
筋肉	jbrz
金帅	jbuk
金顺	jbuy
劲松	jbss
尽速	jbsu
金台	jbtd
金坛	jbtj
津彤	jbts
近月	jbyt
金寨	jbvd
靖邦	jkbh
井壁	jkbi
靖边	jkbm
劲草	jkcc
精巢	jkic
精赤	jkii
泾川	jkir
精纯	jkiy
精当	jkdh
竞斗	jkdz
颈段	jkdr
警号	jkhc
颈环	jkhr
竟会	jkhv
经卷	jkjr
精料	jkln
径流	jklq
精龙	jkls
惊马	jkma
精囊	jknh
竟日	jkri
警容	jkrs
精肉	jkrz
静爽	jkul
靖顺	jkuy
竞速	jksu
荆条	jktn
精铁	jktp
晶妥	jkto
井蛙	jkwa
敬挽	jkwj
警械	jkxp
竞秀	jkxq
警讯	jkxy
精要	jkyc
经由	jkyz
京兆	jkvc
窘促	jscu
窘状	jsvl
旧案	jqan
酒保	jqbc
就便	jqbm
九重	jqis
就道	jqdc
九鼎	jqdk
揪斗	jqdz
旧恶	jqee
厩肥	jqfw
纠风	jqfg
久旱	jqhj
就歼	jqjm
九卷	jqjr
酒客	jqke
旧莫	jqmo
酒囊	jqnh
久诺	jqno
旧情	jqqk
酒曲	jqqu
就让	jqrh
揪痧	jqua
救伤	jquh
酒芍	jquc
酒肆	jqsi
九台	jqtd
酒坛	jqtj
旧套	jqtc
旧体	jqti
救亡	jqwh
酒瓮	jqwg
韭芽	jqya
酒盏	jqvj
九转	jqvr
舅子	jqzi
九族	jqzu
举哀	juai
巨棒	jubh
巨擘	jubo
聚财	jucd
巨铲	juij
居巢	juic
锯床	juil
句读	judz
菊粉	juff
橘柑	jugj
巨匠	jujl
雎鸠	jujq
巨口	jukz
聚类	julw
拘挛	julr
局麻	juma
巨蟒	jumh
莒南	junj
局骗	jupm
拘票	jupn
拒聘	jupb
巨蛆	juqu
巨阙	juqt
句容	jurs
巨商	juuh
巨神	juuf
聚生	juug
巨泰	jutd
剧坛	jutj
举要	juyc
巨野	juye
拒载	juzd
举债	juvd
卷柏	jrbd
绢本	jrbf
鄄城	jrig
蠲除	jriu
卷次	jrci
涓滴	jrdi
圈肥	jrfw
卷积	jrji
卷面	jrmm
眷念	jrnm
捐弃	jrqi
卷刃	jrrf
捐税	jruv
绢丝	jrsi
倦态	jrtd
卷筒	jrts
蠲哮	jrxn
卷须	jrxu
蕨菜	jtcd
绝倒	jtdc
角儿	jter
绝骨	jtgu
掘开	jtkk
掘客	jtke
绝灭	jtmp
绝命	jtmk
绝品	jtpb
蕨墙	jtql
绝热	jtre
绝收	jtuz
矍铄	jtuo
绝嗣	jtsi
绝天	jttm
镢头	jttz
绝续	jtxu
诀要	jtyc
蕨叶	jtye
厥阴	jtyb
绝早	jtzc
谲诈	jtva
抉摘	jtvd
觉着	jtve
峻拔	jyba
菌柄	jybk
军博	jybo
俊才	jycd
均昌	jyih
军风	jyfg
菌杆	jygj
军徽	jyhv
军警	jyjk
君凯	jykk
军垦	jykf
军控	jyks
筠连	jylm
军粮	jyll
君临	jylb
菌落	jylo
军帽	jymc
菌苗	jymn
菌幕	jymu
俊宁	jynk
君侬	jyns
军品	jypb
君然	jyrj
军嫂	jysc
君山	jyuj
军属	jyuu
菌丝	jysi
菌托	jyto
君吻	jywf
军需	jyxu
俊雅	jyya
均沾	jyvj
军政	jyvg
喀吧	kaba
卡比	kabi
卡铂	kabo
卡尺	kaii
卡带	kadd
卡德	kade
卡多	kadz
卡恩	kaen
卡尔	kaer
卡格	kage
卡规	kagv
卡汉	kahj
卡环	kahr
咔叽	kaji
卡拉	kala
卡莱	kald
卡兰	kalj
卡雷	kalw
卡隆	kals
卡伦	kaly
卡迈	kamd
卡姆	kamu
卡帕	kapa
卡其	kaqi
卡钳	kaqm
卡券	kaqr
卡瑞	karv
卡杉	kauj
卡神	kauf
卡水	kauv
卡死	kasi
卡松	kass
喀痰	katj
卡瓦	kawa
卡位	kaww
卡文	kawf
咯血	kaxp
卡雅	kaya
卡孕	kayy
卡纸	kavi
卡兹	kazi
开拔	kkba
开本	kkbf
开标	kkbn
开播	kkbo
开槽	kkcc
开衩	kkia
开场	kkih
开秤	kkig
开船	kkir
开创	kkil
开春	kkiy
开打	kkda
开端	kkdr
开盾	kkdy
凯尔	kker
开发	kkfa
开饭	kkfj
凯纷	kkff
开封	kkfg
凯歌	kkge
开光	kkgl
开航	kkhh
开户	kkhu
开怀	kkhk
开荒	kkhl
开会	kkhv
开荤	kkhy
开镜	kkjk
开卷	kkjr
开掘	kkjt
开垦	kkkf
开口	kkkz
凯拉	kkla
开朗	kklh
凯雷	kklw
开溜	kklq
开滦	kklr
开迈	kkmd
开明	kkmk
楷模	kkmo
恺诺	kkno
开盘	kkpj
开辟	kkpi
开篇	kkpm
开票	kkpn
开平	kkpk
开窍	kkqn
慨然	kkrj
开设	kkue
开审	kkuf
开涮	kkur
开水	kkuv
开顺	kkuy
开锁	kkso
凯塔	kkta
开台	kktd
慨叹	kktj
开膛	kkth
凯特	kkte
楷体	kkti
开头	kktz
开挖	kkwa
开外	kkwd
开往	kkwh
开悟	kkwu
开心	kkxb
凯旋	kkxr
开学	kkxt
开阳	kkyh
开业	kkye
开印	kkyb
揩油	kkyz
慨允	kkyy
开凿	kkzc
开闸	kkva
开斋	kkvd
开支	kkvi
开罪	kkzv
刊本	kjbf
刊播	kjbo
看车	kjie
莰醇	kjiy
堪当	kjdh
勘定	kjdk
看顾	kjgu
看开	kjkk
刊落	kjlo
坎农	kjns
莰酮	kjts
刊文	kjwf
刊行	kjxk
侃爷	kjye
龛影	kjyk
坎子	kjzi
糠秕	khbi
抗病	khbk
康达	khda
康得	khde
抗敌	khdi
康恩	khen
抗感	khgj
抗核	khhe
抗婚	khhy
扛活	khho
康健	khjm
亢进	khjb
抗捐	khjr
抗菌	khjy
慷慨	khkk
抗联	khlm
抗流	khlq
康马	khma
抗魔	khmo
康能	khng
康尼	khni
康诺	khno
康哌	khpd
康平	khpk
康衢	khqu
康容	khrs
康锐	khrv
康萨	khsa
康肾	khuf
康寿	khuz
抗栓	khur
抗税	khuv
康泰	khtd
康铜	khts
抗倭	khwo
康县	khxm
抗性	khxk
炕沿	khyj
抗药	khyc
抗御	khyu
康赞	khzj
康庄	khvl
炕桌	khvo
考霸	kcba
考妣	kcbi
考宾	kcbb
烤翅	kcii
拷绸	kciz
考订	kcdk
考恩	kcen
考尔	kcer
考格	kcge
考根	kcgf
考工	kcgs
靠耩	kcjl
考据	kcju
考克	kcke
考雷	kclw
考林	kclb
考伦	kcly
考王	kcwh
考学	kcxt
靠椅	kcyi
靠枕	kcvf
靠准	kcvy
客帮	kebh
可擦	keca
髁槽	kecc
珂丹	kedj
克东	keds
科尔	keer
科伐	kefa
客房	kefg
克非	kefw
髁杆	kegj
可怪	kegk
可还	kehd
克癀	kehl
客货	keho
氪金	kejb
课卷	kejr
克卡	keka
咳康	kekh
克朗	kelh
科雷	kelw
髁梁	kell
咳灵	kelk
克罗	kelo
稞麦	kemd
科盲	kemh
可耐	kend
可恼	kenc
渴念	kenm
咳宁	kenk
咳清	keqk
溘然	kerj
克日	keri
可溶	kers
克瑞	kerv
可润	kery
克赛	kesd
客岁	kesv
咳泰	ketd
克痛	kets
克托	keto
咳丸	kewj
刻下	kexx
渴想	kexl
科雅	keya
课业	keye
可由	keyz
苛杂	keza
可着	keve
克重	kevs
髁轴	kevz
髁柱	kevu
恪遵	kezy
客座	kezo
垦覆	kffu
肯杰	kfjp
垦利	kfli
肯纳	kfna
垦区	kfqu
啃噬	kfui
肯特	kfte
恳托	kfto
垦种	kfvs
坑井	kgjk
铿铿	kgkg
坑口	kgkz
坑木	kgmu
铿然	kgrj
坑杀	kgua
空巢	ksic
空车	ksie
空处	ksiu
控窗	ksil
空带	ksdd
孔道	ksdc
空额	ksee
空儿	kser
空乏	ksfa
空费	ksfw
空港	ksgh
控购	ksgz
空壶	kshu
空怀	kshk
孔教	ksjn
孔径	ksjk
恐鹫	ksjq
空栏	kslj
孔林	kslb
空落	kslo
空漠	ksmo
空炮	kspc
空腔	ksql
空勤	ksqb
空日	ksri
空身	ksuf
空驶	ksui
空疏	ksuu
空文	kswf
空暇	ksxx
恐蝎	ksxp
空援	ksyr
空竹	ksvu
空转	ksvr
倥偬	kszs
抠逼	kzbi
口称	kzig
口传	kzir
口疮	kzil
口唇	kziy
叩打	kzda
蔻丹	kzdj
口道	kzdc
扣儿	kzer
叩关	kzgr
口惠	kzhv
叩阍	kzhy
口洁	kzjp
口紧	kzjb
芤脉	kzmd
口蘑	kzmo
口轻	kzqk
口诵	kzss
抠搜	kzsz
抠唆	kzso
口泰	kztd
口谈	kztj
扣题	kzti
口外	kzwd
口腕	kzwj
口占	kzvj
库藏	kuch
枯肠	kuih
库车	kuie
库德	kude
库缎	kudr
库尔	kuer
库房	kufg
酷好	kuhc
枯涸	kuhe
酷黑	kuhw
苦活	kuho
苦口	kukz
库兰	kulj
酷烈	kulp
哭灵	kulk
库玛	kuma
库纳	kuna
枯钳	kuqm
哭腔	kuql
苦情	kuqk
裤裙	kuqy
苦人	kurf
库森	kusf
苦参	kuuf
苦事	kuui
枯桃	kutc
苦藤	kutg
苦夏	kuxx
裤线	kuxm
枯朽	kuxq
枯须	kuxu
窟宅	kuvd
裤装	kuvl
枯坐	kuzo
夸诞	kxdj
挎斗	kxdz
跨径	kxjk
夸克	kxke
跨上	kxuh
夸说	kxuo
夸脱	kxto
跨业	kxye
侉子	kxzi
夸嘴	kxzv
快板	kkbj
快度	kkdu
快斧	kkfu
块根	kkgf
快克	kkke
快力	kkli
快男	kknj
快枪	kkql
快事	kkui
快手	kkuz
快痛	kkts
快像	kkxl
快语	kkyu
块状	kkvl
宽病	krbk
款步	krbu
宽城	krig
宽绰	kriz
宽甸	krdm
款冬	krds
髋骨	krgu
宽轨	krgv
宽和	krhe
宽假	krjx
宽解	krjp
宽旷	krkl
款留	krlq
宽免	krmm
款洽	krqx
款曲	krqu
宽让	krrh
宽饶	krrc
款型	krxk
宽胸	krxs
宽宥	kryz
宽展	krvj
款识	krvi
款子	krzi
宽纵	krzs
狂草	klcc
矿层	klcg
矿场	klih
矿车	klie
矿床	klil
旷代	kldd
旷荡	kldh
框定	kldk
矿洞	klds
狂喊	klhj
狂呼	klhu
匡计	klji
矿浆	kljl
匡救	kljq
矿坑	klkg
狂澜	kllj
狂雷	kllw
矿棉	klmm
矿苗	klmn
匡谬	klmq
矿泥	klni
狂怒	klnu
狂气	klqi
狂钳	klqm
狂肆	klsi
匡算	klsr
矿体	klti
矿田	kltm
况味	klww
狂泻	klxp
矿渣	klva
矿长	klvh
狂爪	klvc
奎艾	kvai
魁岸	kvan
溃兵	kvbk
跬步	kvbu
窥察	kvia
亏得	kvde
溃堤	kvdi
奎恩	kven
亏负	kvfu
愧汗	kvhj
亏耗	kvhc
愧恨	kvhf
愧悔	kvhv
匮竭	kvjp
溃决	kvjt
溃军	kvjy
睽睽	kvkv
喹啉	kvlb
愧领	kvlk
溃乱	kvlr
盔帽	kvmc
溃灭	kvmp
愧赧	kvnj
奎宁	kvnk
匮缺	kvqt
溃散	kvsj
葵扇	kvuj
魁首	kvuz
窥伺	kvsi
愧痛	kvts
奎屯	kvty
奎文	kvwf
魁星	kvxk
葵严	kvyj
奎因	kvyb
盔子	kvzi
愧怍	kvzo
困惫	kybw
坤表	kybn
昆季	kyji
困觉	kyjn
坤宁	kynk
昆腔	kyql
困穷	kyqs
困人	kyrf
昆山	kyuj
困守	kyuz
捆扎	kyza
坤造	kyzc
昆仲	kyvs
阔绰	koiz
廓落	kolo
廓清	koqk
扩权	koqr
阔人	korf
扩增	kozg
拉德	lade
拉恩	laen
拉尔	laer
拉非	lafw
拉夫	lafu
拉杆	lagj
拉钩	lagz
拉货	laho
辣酱	lajl
拉卡	laka
拉开	lakk
蜡泪	lalw
蜡疗	laln
拉门	lamf
蜡膜	lamo
拉娜	lana
拉纤	laqm
蜡染	larj
蜡人	larf
腊日	lari
蜡勺	lauc
拉丝	lasi
拉套	latc
拉文	lawf
拉乌	lawu
拉秧	layh
蜡油	layz
拉运	layy
拉账	lavh
蜡纸	lavi
莱城	ldig
莱顿	lddy
莱恩	lden
莱尔	lder
来访	ldfg
莱菔	ldfu
癞瓜	ldgx
来归	ldgv
来鸿	ldhs
赖婚	ldhy
来火	ldho
来佳	ldjx
来件	ldjm
来料	ldln
莱纳	ldna
莱能	ldng
莱尼	ldni
莱帕	ldpa
莱琪	ldqi
莱塞	ldse
莱山	lduj
来书	lduu
涞水	lduv
莱斯	ldsi
来岁	ldsv
来婷	ldtk
莱芜	ldwu
莱西	ldxi
赖学	ldxt
莱泽	ldze
赖债	ldvd
癞爪	ldvc
莱州	ldvz
澜沧	ljch
揽承	ljig
兰达	ljda
懒怠	ljdd
兰董	ljds
蓝顿	ljdy
懒惰	ljdz
兰恩	ljen
烂耳	ljer
蓝矾	ljfj
岚皋	ljgc
揽工	ljgs
蓝河	ljhe
懒猴	ljhz
蓝甲	ljjx
兰卡	ljka
兰考	ljkc
蓝空	ljks
兰拉	ljla
蓝龙	ljls
蓝魔	ljmo
蓝胖	ljph
蓝喷	ljpf
澜琪	ljqi
蓝芩	ljqb
揽权	ljqr
阑入	ljru
蓝腮	ljsd
兰森	ljsf
滥觞	ljuh
兰苏	ljsu
缆索	ljso
烂苔	ljtd
蓝移	ljyi
蓝藻	ljzc
栏栅	ljva
蓝阵	ljvf
蓝痣	ljvi
浪船	lhir
狼疮	lhil
廊道	lhdc
浪蝶	lhdp
朗恩	lhen
廊坊	lhfg
狼獾	lhhr
浪尖	lhjm
郎舅	lhjq
廊庙	lhmn
朗铭	lhmk
浪木	lhmu
狼骑	lhqi
浪桥	lhqn
浪茄	lhqp
朗清	lhqk
朗瑞	lhrv
浪舞	lhwu
郎溪	lhxi
朗县	lhxm
狼心	lhxb
狼妖	lhyc
朗依	lhyi
浪语	lhyu
阆苑	lhyr
朗悦	lhyt
狼爪	lhvx
老媪	lcao
老边	lcbm
劳步	lcbu
老财	lccd
老苍	lcch
老厂	lcih
唠扯	lcie
老粗	lccu
老旦	lcdj
牢度	lcdu
劳恩	lcen
劳乏	lcfa
老赶	lcgj
老鸹	lcgx
老倌	lcgr
老光	lcgl
涝害	lchd
劳倦	lcjr
劳军	lcjy
劳伦	lcly
老米	lcmi
老命	lcmk
老农	lcns
老女	lcnv
老气	lcqi
老亲	lcqb
老拳	lcqr
劳瑞	lcrv
老弱	lcro
老僧	lcsg
老生	lcug
老帅	lcuk
老叟	lcsz
酪酸	lcsr
老汤	lcth
乐亭	lctk
牢稳	lcwf
涝灾	lczd
乐安	lean
勒逼	lebi
乐昌	leih
乐道	ledc
乐东	leds
乐都	ledu
乐儿	leer
乐芬	leff
乐盖	legd
乐果	lego
乐和	lehe
乐衡	lehg
乐净	lejk
乐亢	lekh
乐来	leld
乐朗	lelh
乐乐	lele
乐力	leli
乐脉	lemd
勒秒	lemn
乐平	lepk
乐青	leqk
乐松	less
乐天	letm
乐唯	leww
乐武	lewu
乐业	leye
乐友	leyz
乐至	levi
雷暴	lwbc
泪奔	lwbf
雷波	lwbo
雷场	lwih
雷锤	lwiv
累次	lwci
雷德	lwde
雷蒂	lwdi
羸顿	lwdy
雷恩	lwen
蕾尔	lwer
雷斧	lwfu
雷公	lwgs
雷害	lwhd
类核	lwhe
类乎	lwhu
雷魂	lwhy
累活	lwho
雷角	lwjn
雷酒	lwjq
类聚	lwju
雷卡	lwka
雷克	lwke
蕾拉	lwla
雷链	lwlm
雷鳞	lwlb
蕾铃	lwlk
雷龙	lwls
累卵	lwlr
雷玛	lwma
雷矛	lwmc
雷眉	lwmw
雷门	lwmf
雷米	lwmi
肋膜	lwmo
雷纳	lwna
雷尼	lwni
累年	lwnm
雷鸟	lwnn
雷宁	lwnk
雷欧	lwou
垒墙	lwql
泪然	lwrj
雷瑟	lwse
雷山	lwuj
雷松	lwss
雷蹄	lwti
肋条	lwtn
雷丸	lwwj
雷沃	lwwo
雷希	lwxi
耒阳	lwyh
泪液	lwye
雷翼	lwyi
雷音	lwyb
雷云	lwyy
雷州	lwvz
嫘祖	lwzu
雷尊	lwzy
冷餐	lgcj
冷嘲	lgic
冷齿	lgii
冷床	lgil
冷点	lgdm
冷丁	lgdk
冷钢	lggh
冷光	lggl
冷害	lghd
冷湖	lghu
冷话	lghx
冷荤	lghy
冷货	lgho
冷噤	lgjb
冷觉	lgjt
冷厉	lgli
冷面	lgmm
冷峭	lgqn
冷泉	lgqr
冷杉	lguj
冷伤	lguh
愣神	lguf
冷霜	lgul
冷缩	lgso
棱台	lgtd
冷心	lgxb
冷硬	lgyk
冷轧	lgva
棱锥	lgvv
里昂	liah
丽邦	libh
历本	libf
罹病	libk
李沧	lich
蠡测	lice
里层	licg
历陈	liif
力持	liii
李村	licy
立等	lidg
理短	lidr
利钝	lidy
利恩	lien
利尔	lier
立方	lifg
利肺	lifw
利肝	ligj
梨膏	ligc
里根	ligf
蠡沟	ligz
犁骨	ligu
黧黑	lihw
力弘	lihs
立候	lihz
罹祸	liho
历久	lijq
立决	lijt
里卡	lika
离开	likk
利口	likz
利兰	lilj
莉蕾	lilw
离乱	lilr
厘摩	limo
力能	ling
犁牛	linq
力诺	lino
离叛	lipj
黎平	lipk
利钱	liqm
李群	liqy
栗然	lirj
立绒	lirs
立射	liue
力深	liuf
里手	liuz
李算	lisr
李遂	lisv
利他	lita
力太	litd
力坦	litj
犁田	litm
利通	lits
李陀	lito
立文	liwf
立业	liye
丽泽	lize
篱栅	liva
离辙	live
立轴	livz
利爪	livx
链表	lmbn
联产	lmij
联唱	lmih
联电	lmdm
镰斧	lmfu
连杆	lmgj
恋歌	lmge
连亘	lmgf
脸厚	lmhz
联会	lmhv
联觉	lmjt
联可	lmke
连夼	lmkl
帘栊	lmls
链轮	lmly
帘幕	lmmu
连南	lmnj
恋奴	lmnu
连平	lmpk
连翘	lmqn
恋群	lmqy
联双	lmul
涟水	lmuv
莲台	lmtd
练摊	lmtj
炼铁	lmtp
联销	lmxn
连写	lmxp
连选	lmxr
恋洋	lmyh
连用	lmys
连种	lmvs
联奏	lmzz
敛足	lmzu
亮邦	llbh
靓包	llbc
两鬓	llbb
亮博	llbo
两重	llis
莨绸	lliz
两当	lldh
凉碟	lldp
粮囤	lldy
良多	lldz
亮儿	ller
量规	llgv
两汉	llhj
梁河	llhe
两淮	llhk
粮荒	llhl
两晋	lljb
亮鳞	lllb
亮绿	lllv
良马	llma
凉帽	llmc
粮秣	llmo
亮木	llmu
粮农	llns
粮票	llpn
粮区	llqu
量热	llre
量算	llsr
亮跃	llyt
两造	llzc
凉枕	llvf
蓼参	lncj
料车	lnie
燎尘	lnif
了当	lndh
撂地	lndi
疗毒	lndu
撂荒	lnhl
了局	lnju
撩开	lnkk
蓼蓝	lnlj
燎泡	lnpc
料峭	lnqn
聊且	lnqp
燎群	lnqy
撩惹	lnre
瞭哨	lnuc
了事	lnui
撂手	lnuz
辽西	lnxi
燎雨	lnyu
辽中	lnvs
僚佐	lnzo
列兵	lpbk
猎场	lpih
猎齿	lpii
烈度	lpdu
裂谷	lpgu
裂化	lphx
裂解	lpjp
裂筋	lpjb
裂开	lpkk
裂颅	lplu
劣魔	lpmo
裂脑	lpnc
列宁	lpnk
裂片	lppm
劣品	lppb
列沁	lpqb
裂球	lpqq
列缺	lpqt
烈山	lpuj
裂伤	lpuh
劣绅	lpuf
烈属	lpuu
裂蹄	lpti
裂天	lptm
猎枭	lpxn
列选	lpxr
猎月	lpyt
裂云	lpyy
劣种	lpvs
列传	lpvr
猎装	lpvl
裂钻	lpzr
鳞癌	lbai
临安	lban
林比	lbbi
邻边	lbbm
鳞波	lbbo
临沧	lbch
邻层	lbcg
临朝	lbic
临城	lbig
临池	lbii
临川	lbir
林丛	lbcs
邻村	lbcy
林带	lbdd
临汾	lbff
临风	lbfg
临高	lbgc
林冠	lbgr
临桂	lbgv
林喉	lbhz
林克	lbke
林口	lbkz
临了	lbln
林龄	lblk
林莽	lbmh
林奈	lbnd
琳妮	lbni
林农	lbns
林檎	lbqb
邻人	lbrf
临汝	lbru
林姗	lbuj
邻舍	lbue
临沭	lbuu
临泰	lbtd
临潭	lbtj
檩条	lbtn
林蛙	lbwa
林网	lbwh
鳞屑	lbxp
麟游	lbyz
林云	lbyy
临泽	lbze
临漳	lbvh
鳞爪	lbvc
林政	lbvg
灵宝	lkbc
灵璧	lkbi
凌波	lkbo
灵床	lkil
灵达	lkda
铃的	lkde
铃铎	lkdz
灵幡	lkfj
灵符	lkfu
领港	lkgh
领钩	lkgz
灵怪	lkgk
领馆	lkgr
凌河	lkhe
灵猴	lkhz
领巾	lkjb
灵境	lkjk
领款	lkkr
零料	lkln
领命	lkmk
菱脑	lknc
羚牛	lknq
灵诺	lkno
令女	lknv
灵棚	lkpg
零票	lkpn
伶俜	lkpk
灵丘	lkqq
灵山	lkuj
零上	lkuh
灵台	lktd
陵替	lkti
灵网	lkwh
令闻	lkwf
令兄	lkxs
龄学	lkxt
凌杂	lkza
领章	lkvh
领奏	lkzz
硫胺	lqan
刘骜	lqao
留坝	lqba
刘邦	lqbh
流弊	lqbi
留别	lqbp
流播	lqbo
流荡	lqdh
馏分	lqff
流风	lqfg
六腑	lqfu
六根	lqgf
硫胍	lqgx
溜号	lqhc
六户	lqhu
榴火	lqho
六甲	lqjx
柳江	lqjl
留居	lqju
六轮	lqly
遛马	lqma
柳眉	lqmw
留门	lqmf
柳绵	lqmm
流民	lqmb
柳木	lqmu
流脑	lqnc
瘤牛	lqnq
流盼	lqpj
流气	lqqi
硫桥	lqqn
留情	lqqk
琉球	lqqq
柳杉	lquj
柳丝	lqsi
柳条	lqtn
流徙	lqxi
流泻	lqxp
溜圆	lqyr
流云	lqyy
留针	lqvf
留种	lqvs
溜桌	lqvo
留足	lqzu
龙勃	lsbo
隆昌	lsih
龙城	lsig
龙齿	lsii
茏葱	lscs
隆德	lsde
龙灯	lsdg
笼盖	lsgd
垄沟	lsgz
龙痕	lshf
龙喉	lshz
龙脊	lsji
龙江	lsjl
龙鹫	lsjq
龙卷	lsjr
癃开	lskk
砻糠	lskh
龙葵	lskv
龙类	lslw
龙里	lsli
龙陵	lslk
龙卵	lslr
龙蟒	lsmh
垄奴	lsnu
龙女	lsnv
龙泉	lsqr
龙沙	lsua
龙山	lsuj
隆盛	lsug
龙首	lsuz
弄堂	lsth
龙湾	lswj
龙文	lswf
龙舞	lswu
陇西	lsxi
龙哮	lsxn
隆尧	lsyc
龙鹰	lsyk
龙游	lsyz
龙渊	lsyr
龙崽	lszd
龙枣	lszc
龙掌	lsvh
龙爪	lsvx
隆准	lsvy
拢总	lszs
垄作	lszo
露白	lzbd
楼板	lzbj
露丑	lziz
漏窗	lzil
娄烦	lzfj
露富	lzfu
楼盖	lzgd
瘘管	lzgr
漏光	lzgl
陋规	lzgv
漏壶	lzhu
镂花	lzhx
漏检	lzjm
漏抗	lzkh
镂刻	lzke
镂空	lzks
漏芦	lzlu
漏码	lzma
漏尿	lznn
露怯	lzqp
楼群	lzqy
漏勺	lzuc
陋俗	lzsu
漏脱	lzto
漏泄	lzxp
娄星	lzxk
陋岩	lzyj
漏夜	lzye
漏嘴	lzzv
路霸	luba
卢比	lubi
芦柴	luid
露畅	luih
陆川	luir
鸬鹚	luci
芦荡	ludh
鲁恩	luen
录放	lufg
芦根	lugf
路环	luhr
卤碱	lujm
庐江	lujl
路劫	lujp
露酒	lujq
卢卡	luka
鲁坎	lukj
鲁克	luke
鹿盔	lukv
陆良	lull
卢龙	luls
路南	lunj
颅脑	lunc
陆棚	lupg
鹿皮	lupi
陆坡	lupo
路卡	luqx
颅腔	luql
鹿肉	lurz
卢瑟	luse
卢森	lusf
庐舍	luue
鹿肾	luuf
芦淞	luss
露髓	lusv
炉膛	luth
陆涛	lutc
炉瓦	luwa
颅外	luwd
炉温	luwf
颅狭	luxx
鹿野	luye
鹿苑	luyr
鲁赞	luzj
炉渣	luva
路政	luvg
卵白	lrbd
乱兵	lrbk
栾城	lrig
乱齿	lrii
栾川	lrir
滦河	lrhe
乱乎	lrhu
卵黄	lrhl
乱纪	lrji
孪晶	lrjk
卵孔	lrks
卵块	lrkk
乱离	lrli
卵裂	lrlp
乱民	lrmb
滦南	lrnj
滦平	lrpk
乱枪	lrql
乱情	lrqk
乱射	lrue
挛缩	lrso
乱弹	lrtj
乱腾	lrtg
娈童	lrts
滦县	lrxm
卵形	lrxk
卵翼	lryi
乱营	lryk
乱羽	lryu
乱杂	lrza
峦嶂	lrvh
卵质	lrvi
掠虹	lths
略图	lttu
略阳	ltyh
伦巴	lyba
轮埠	lybu
轮齿	lyii
论丛	lycs
论敌	lydi
轮渡	lydu
轮辐	lyfu
论功	lygs
轮毂	lygu
论价	lyjx
沦没	lymo
轮牧	lymu
论难	lynj
轮盘	lypj
伦琴	lyqb
轮系	lyxi
轮作	lyzo
萝北	lobw
罗布	lobu
落尘	loif
洛川	loir
落锤	loiv
罗顿	lody
洛恩	loen
落帆	lofj
洛菲	lofw
落凤	lofg
螺杆	logj
罗戈	loge
螺号	lohc
漯河	lohe
落荒	lohl
罗杰	lojp
罗经	lojk
螺距	loju
螺菌	lojy
洛卡	loka
裸考	lokc
罗口	lokz
罗拉	lola
罗兰	lolj
罗勒	lole
裸麦	lomd
罗曼	lomj
洛美	lomw
洛那	lona
罗尼	loni
落聘	lopb
罗平	lopk
洛浦	lopu
洛奇	loqi
洛庆	loqk
洛屈	loqu
络却	loqt
罗瑞	lorv
洛萨	losa
络纱	loua
裸鼠	louu
螺栓	lour
落套	lotc
罗田	lotm
洛亭	lotk
络通	lots
洛威	loww
洛希	loxi
洛欣	loxb
落星	loxk
落雪	loxt
洛雅	loya
裸眼	loyj
落音	loyb
落英	loyk
落雨	loyu
罗源	loyr
洛扎	lova
落账	lovh
罗珍	lovf
氯胺	lvan
氯苯	lvbf
滤泵	lvbg
缕陈	lvif
绿党	lvdh
绿岛	lvdc
氯仿	lvfg
率谷	lvgu
氯胍	lvgx
滤过	lvgo
绿甲	lvjx
率角	lvjn
氯喹	lvkv
吕梁	lvll
律令	lvlk
绿龙	lvls
氯纶	lvly
驴骡	lvlo
铝镁	lvmw
旅鸟	lvnn
滤清	lvqk
绿鳃	lvsd
驴肾	lvuf
稆生	lvug
履霜	lvul
绿松	lvss
绿塔	lvta
律条	lvtn
绿铁	lvtp
旅团	lvtr
绿纹	lvwf
缕析	lvxi
闾巷	lvxl
履新	lvxb
绿炫	lvxr
绿雪	lvxt
氯亚	lvya
绿腰	lvyc
绿意	lvyi
绿园	lvyr
滤渣	lvva
绿爪	lvvc
旅者	lvve
绿竹	lvvu
律宗	lvzs
码本	mabf
马鳖	mabp
马兵	mabk
马槽	macc
麻城	maig
马刺	maci
马村	macy
玛蒂	madi
马店	madm
马丁	madk
马队	madv
玛尔	maer
麻秆	magj
马号	mahc
马赫	mahe
麻后	mahz
马裤	maku
蚂螂	malh
马料	maln
马列	malp
马龙	mals
马骡	malo
骂名	mamk
马奶	mand
马趴	mapa
马枪	maql
玛沁	maqb
马球	maqq
玛曲	maqu
摩挲	masa
马森	masf
马勺	mauc
麻绳	maug
麻石	maui
玛特	mate
马铁	matp
码文	mawf
马萧	maxn
马谢	maxp
马熊	maxs
马修	maxq
麻阳	mayh
码元	mayr
马贼	mazw
马站	mavj
妈祖	mazu
买办	mdbj
麦草	mdcc
麦茬	mdia
卖呆	mddd
麦蛾	mdee
麦风	mdfg
卖功	mdgs
埋骨	mdgu
麦角	mdjn
迈克	mdke
麦浪	mdlh
麦琳	mdlb
麦芒	mdmh
脉门	mdmf
麦苗	mdmn
麦姆	mdmu
麦胚	mdpw
脉平	mdpk
麦秋	mdqq
脉舒	mduu
埋汰	mdtd
迈腾	mdtg
麦莛	mdtk
麦瓦	mdwa
霡欣	mdxb
麦须	mdxu
卖友	mdyz
买账	mdvh
脉枕	mdvf
脉证	mdvg
麦种	mdvs
慢班	mjbj
瞒报	mjbc
漫笔	mjbi
蛮兵	mjbk
蔓草	mjcc
蛮缠	mjij
螨虫	mjis
满处	mjiu
蛮锤	mjiv
慢词	mjci
满地	mjdi
满额	mjee
鳗钙	mjgd
瞒哄	mjhs
曼胡	mjhu
漫漶	mjhr
漫记	mjji
慢件	mjjm
蔓菁	mjjk
漫卷	mjjr
漫流	mjlq
蛮龙	mjls
曼尼	mjni
蛮牛	mjnq
蛮皮	mjpi
满勤	mjqb
满人	mjrf
漫射	mjue
曼声	mjug
满师	mjui
满婷	mjtk
慢痛	mjts
满文	mjwf
蛮妖	mjyc
幔帐	mjvh
慢支	mjvi
蛮鬃	mjzs
莽苍	mhch
芒刺	mhci
盲动	mhds
盲干	mhgj
盲谷	mhgu
盲光	mhgl
芒康	mhkh
盲签	mhqm
蟒藤	mhtg
盲童	mhts
盲信	mhxb
茫崖	mhya
盲眼	mhyj
莽原	mhyr
忙月	mhyt
盲字	mhzi
茅庵	mcan
茂巴	mcba
锚泊	mcbo
毛布	mcbu
毛茶	mcia
冒场	mcih
耄耋	mcdp
冒渎	mcdu
茂尔	mcer
毛根	mcgf
帽化	mchx
锚环	mchr
铆接	mcjp
帽盔	mckv
毛拉	mcla
毛蓝	mclj
冒码	mcma
茂南	mcnj
毛囊	mcnh
茅棚	mcpg
毛票	mcpn
毛球	mcqq
毛渠	mcqu
毛人	mcrf
帽衫	mcuj
卯榫	mcsy
毛桃	mctc
毛条	mctn
毛袜	mcwa
猫王	mcwh
锚位	mcww
毛细	mcxi
毛虾	mcxx
茂欣	mcxb
猫熊	mcxs
毛选	mcxr
毛样	mcyh
毛躁	mczc
毛毡	mcvj
毛痣	mcvi
毛装	mcvl
矛鬃	mczs
美安	mwan
眉笔	mwbi
美餐	mwcj
煤层	mwcg
煤车	mwie
煤尘	mwif
眉冲	mwis
美传	mwir
梅达	mwda
没顶	mwdk
眉端	mwdr
梅恩	mwen
梅尔	mwer
镁光	mwgl
美红	mwhs
梅江	mwjl
煤焦	mwjn
煤块	mwkk
眉棱	mwlg
梅列	mwlp
梅洛	mwlo
美侬	mwns
眉批	mwpi
美平	mwpk
酶切	mwqp
梅森	mwsf
媚态	mwtd
魅香	mwxl
美型	mwxk
妹婿	mwxu
魅影	mwyk
美展	mwvj
妹丈	mwvh
门鼻	mfbi
门钹	mfbo
门齿	mfii
门斗	mfdz
门墩	mfdy
门额	mfee
门儿	mfer
门阀	mffa
门扉	mffw
门幅	mffu
门岗	mfgh
闷棍	mfgy
闷倦	mfjr
门客	mfke
门框	mfkl
门廊	mflh
门楼	mflz
门努	mfnu
闷气	mfqi
门墙	mfql
门扇	mfuj
门首	mfuz
扪心	mfxb
门源	mfyr
门子	mfzi
盟邦	mgbh
梦禅	mgij
蒙城	mgig
孟春	mgiy
孟村	mgcy
猛打	mgda
猛地	mgde
猛跌	mgdp
锰钢	mggh
猛攻	mggs
蒙垢	mggz
蒙馆	mggr
勐海	mghd
蒙哄	mghs
猛火	mgho
猛击	mgji
猛将	mgjl
猛鹫	mgjq
勐腊	mgla
孟连	mglm
猛犸	mgma
蒙曼	mgmj
蒙蒙	mgmg
梦娘	mgnl
萌蘖	mgnp
蒙诺	mgno
猛扑	mgpu
孟秋	mgqq
蒙山	mguj
锰铁	mgtp
蒙童	mgts
孟夏	mgxx
孟县	mgxm
蒙学	mgxt
梦叶	mgye
蒙阴	mgyb
孟州	mgvz
梦妆	mgvl
米尺	miii
米袋	midd
嘧啶	midk
密耳	mier
秘法	mifa
靡费	mifw
迷花	mihx
密会	mihv
秘结	mijp
迷津	mijb
蜜橘	miju
米糠	mikh
米拉	mila
米莱	mild
汨罗	milo
弥诺	mino
米奇	miqi
觅求	miqq
米泉	miqr
弥散	misj
密斯	misi
泌特	mite
弥陀	mito
蜜丸	miwj
密写	mixp
秘血	mixt
米雅	miya
米易	miyi
蜜源	miyr
米扎	miva
迷阵	mivf
米粥	mivz
迷踪	mizs
咪唑	mizo
面案	mman
棉棒	mmbh
面表	mmbn
绵参	mmcj
面茶	mmia
渑池	mmii
绵绸	mmiz
冕洞	mmds
棉纺	mmfg
面高	mmgc
面弓	mmgs
棉猴	mmhz
面交	mmjn
面经	mmjk
面宽	mmkr
绵连	mmlm
面裂	mmlp
棉铃	mmlk
冕旒	mmlq
面门	mmmf
面嫩	mmnf
冕宁	mmnk
棉农	mmns
面盆	mmpf
免却	mmqt
面人	mmrf
面商	mmuh
面纹	mmwf
面窝	mmwo
绵远	mmyr
面砖	mmvr
秒摆	mnbd
苗床	mnil
妙方	mnfg
庙号	mnhc
描红	mnhs
苗家	mnjx
描金	mnjb
妙境	mnjk
妙诀	mnjt
妙纳	mnna
妙品	mnpb
苗期	mnqi
苗情	mnqk
渺然	mnrj
妙算	mnsr
苗乡	mnxl
苗绣	mnxq
描叙	mnxu
妙药	mnyc
苗寨	mnvd
灭茬	mpia
蔑称	mpig
灭滴	mpdi
灭点	mpdm
篾工	mpgs
篾黄	mphl
篾匠	mpjl
灭菌	mpjy
灭龙	mpls
蠛蠓	mpmg
篾片	mppm
篾青	mpqk
灭天	mptm
篾条	mptn
篾席	mpxi
乜斜	mpxp
灭蝇	mpyk
篾子	mpzi
民变	mbbm
民船	mbir
敏迪	mbdi
闽侯	mbhz
敏化	mbhx
敏慧	mbhv
民力	mbli
民盟	mbmg
民命	mbmk
民品	mbpb
民勤	mbqb
岷山	mbuj
民庭	mbtk
民望	mbwh
岷县	mbxm
民忧	mbyz
民运	mbyy
民贼	mbzw
民智	mbvi
抿子	mbzi
螟虫	mkis
明春	mkiy
明代	mkdd
鸣笛	mkdi
铭感	mkgj
明沟	mkgz
鸣鼓	mkgu
明光	mkgl
螟害	mkhd
冥虎	mkhu
明黄	mkhl
鸣鸾	mklr
明码	mkma
冥蒙	mkmg
明灭	mkmp
冥牛	mknq
明盘	mkpj
鸣炮	mkpc
名票	mkpn
名品	mkpb
明前	mkqm
鸣禽	mkqb
名儒	mkru
明锐	mkrv
冥蛇	mkue
明水	mkuv
冥思	mksi
名宿	mksu
名特	mkte
名帖	mktp
铭心	mkxb
明秀	mkxq
冥鸦	mkya
明耀	mkyc
名优	mkyz
名章	mkvh
明真	mkvf
鸣啭	mkvr
名状	mkvl
鸣奏	mkzz
谬传	mqir
谬奖	mqjl
谬说	mquo
谬种	mqvs
魔棒	mobh
膜泵	mobg
魔波	mobo
魔尘	moif
磨床	moil
莫丹	modj
蓦地	mode
墨斗	modz
末伏	mofu
魔钢	mogh
莫格	moge
磨工	mogs
魔钩	mogz
魔怪	mogk
魔棍	mogy
墨海	mohd
摩汉	mohj
磨耗	mohc
末后	mohz
摹绘	mohv
魔火	moho
魔剑	mojm
魔君	mojy
摩卡	moka
模考	mokc
魔矿	mokl
茉拉	mola
莫莱	mold
莫雷	molw
模棱	molg
莫伦	moly
莫娜	mona
魔能	mong
莫努	monu
磨盘	mopj
魔球	moqq
默僧	mosg
摩什	mouf
摩丝	mosi
默算	mosr
莫塔	mota
魔藤	motg
魔铁	motp
莫问	mowf
磨洗	moxi
墨线	moxm
模效	moxn
磨削	moxt
魔针	movf
磨嘴	mozv
谋臣	mzif
牟定	mzdk
谋和	mzhe
谋虑	mzlv
谋算	mzsr
某乙	mzyi
穆比	mubi
幕宾	mubb
募兵	mubk
木巢	muic
母畜	muiu
木槌	muiv
目次	muci
墓道	mudc
暮冬	muds
木盾	mudy
牧放	mufg
母妃	mufw
幕府	mufu
牧歌	muge
牧归	mugv
母国	mugo
牧户	muhu
募化	muhx
母皇	muhl
沐火	muho
木枷	mujx
募款	mukr
木垒	mulw
木莲	mulm
木笼	muls
墓门	mumf
木棉	mumm
墓奴	munu
牟平	mupk
幕墙	muql
牧犬	muqr
牧群	muqy
木蛇	muue
木声	muug
木栓	muur
暮岁	musv
穆塔	muta
木糖	muth
沐欣	muxb
母音	muyb
木栅	muva
拇战	muvj
木爪	muvc
牧者	muve
木枕	muvf
母钟	muvs
母座	muzo
钠泵	nabg
纳彩	nacd
纳差	naia
纳川	nair
纳呆	nadd
钠灯	nadg
拿顶	nadk
纳恩	naen
纳贡	nags
拿获	naho
纳洁	najp
钠林	nalb
纳鲁	nalu
纳姆	namu
那宁	nank
那坡	napo
拿乔	naqn
拿权	naqr
那洒	nasa
纳杉	nauj
纳特	nate
那妥	nato
拿问	nawf
纳溪	naxi
纳降	naxl
纳新	naxb
纳雍	nays
拿住	navu
镎族	nazu
耐穿	ndir
奶疮	ndil
氖灯	nddg
乃东	ndds
奈法	ndfa
奶糕	ndgc
奶积	ndji
耐碱	ndjm
奈康	ndkh
耐苦	ndku
奈拉	ndla
奈曼	ndmj
奶毛	ndmc
奶名	ndmk
奈培	ndpw
奶皮	ndpi
奶品	ndpb
奈瑟	ndse
耐受	nduz
耐酸	ndsr
奶味	ndww
奶牙	ndya
奶羊	ndyh
耐战	ndvj
奶罩	ndvc
男宾	njbb
南岔	njia
南朝	njic
南川	njir
南村	njcy
南斗	njdz
南芬	njff
南岗	njgh
南华	njhx
南汇	njhv
男家	njjx
南郊	njjn
南开	njkk
南吕	njlv
南蛮	njmj
南明	njmk
男模	njmo
楠木	njmu
南皮	njpi
南票	njpn
南齐	njqi
难色	njse
南沙	njua
南宋	njss
南通	njts
男团	njtr
南湾	njwj
南县	njxm
南雄	njxs
南音	njyb
南漳	njvh
囊斑	nhbj
囊胞	nhbc
囊虫	nhis
囊膪	nhik
囊胚	nhpw
囊谦	nhqm
囊群	nhqy
脑安	ncan
闹病	ncbk
铙钹	ncbo
蛲虫	ncis
淖尔	ncer
闹房	ncfg
挠钩	ncgz
闹哄	nchs
脑户	nchu
闹荒	nchl
脑际	ncji
脑空	ncks
脑量	ncll
脑瘤	nclq
脑笼	ncls
呶呶	ncnc
脑宁	ncnk
脑泡	ncpc
闹气	ncqi
挠曲	ncqu
硇砂	ncua
脑疝	ncuj
脑肽	nctd
闹天	nctm
脑炎	ncyj
闹灾	nczd
闹贼	nczw
脑汁	ncvi
讷河	nehe
讷讷	nene
内靶	nwba
内宾	nwbb
内场	nwih
内臣	nwif
内城	nwig
内盗	nwdc
内调	nwdn
内耳	nwer
内翻	nwfj
内顾	nwgu
内关	nwgr
内海	nwhd
内黄	nwhl
内江	nwjl
内角	nwjn
内聚	nwju
内刊	nwkj
内愧	nwkv
内贸	nwmc
内冕	nwmm
内难	nwnj
内能	nwng
内皮	nwpi
内丘	nwqq
内瓤	nwrh
内热	nwre
内人	nwrf
内森	nwsf
内渗	nwuf
内水	nwuv
内体	nwti
内湾	nwwj
内卫	nwww
内省	nwxk
内兄	nwxs
内压	nwya
内焰	nwyj
内忧	nwyz
内助	nwvu
内子	nwzi
内阻	nwzu
嫩脆	nfcv
恁地	nfdi
嫩红	nfhs
嫩黄	nfhl
嫩江	nfjl
嫩苗	nfmn
嫩芽	nfya
嫩叶	nfye
能带	ngdd
能级	ngji
能面	ngmm
能谱	ngpu
能隙	ngxi
能效	ngxn
拟办	nibj
匿报	nibc
匿藏	nich
逆产	niij
腻虫	niis
尼达	nida
你等	nidg
尼恩	nien
泥肥	nifw
尼根	nigf
泥工	nigs
泥垢	nigz
匿迹	niji
泥浆	nijl
尼卡	nika
妮拉	nila
逆旅	nilv
尼玛	nima
妮麦	nimd
呢帽	nimc
泥煤	nimw
尼木	nimu
妮娜	nina
泥淖	ninc
妮妮	nini
泥泡	nipc
泥墙	niql
妮萨	nisa
尼舒	niuu
尼松	niss
泥塘	nith
尼特	nite
拟题	niti
泥洼	niwa
泥丸	niwj
逆网	niwh
腻味	niww
逆序	nixu
泥岩	niyj
拟议	niyi
拟音	niyb
泥浴	niyu
尼沅	niyr
溺职	nivi
泥嘴	nizv
拟作	nizo
蔫巴	nmba
念白	nmbd
年辈	nmbw
年菜	nmcd
碾场	nmih
年成	nmig
年齿	nmii
黏虫	nmis
年饭	nmfj
碾坊	nmfg
年根	nmgf
年庚	nmgg
年光	nmgl
黏胶	nmjn
年刊	nmkj
年来	nmld
年率	nmlv
年貌	nmmc
碾盘	nmpj
碾平	nmpk
年人	nmrf
碾砣	nmto
念物	nmwu
年下	nmxx
年宵	nmxn
年在	nmzd
年尊	nmzy
娘儿	nler
酿酶	nlmw
娘姨	nlyi
尿垫	nndm
鸟粪	nnff
尿苷	nngj
鸟害	nnhd
尿炕	nnkh
尿裤	nnku
尿量	nnll
尿瘘	nnlz
尿囊	nnnh
尿片	nnpm
袅绕	nnrc
鸟兽	nnuz
鸟窝	nnwo
尿血	nnxp
鸟爪	nnvc
涅白	npbd
镍币	npbi
啮齿	npii
镍钢	npgh
颞骨	npgu
孽海	nphd
捏积	npji
啮甲	npjx
捏弄	npns
颞浅	npqm
聂荣	nprs
颞叶	npye
蹑踪	npzs
蹑足	npzu
宁安	nkan
凝碧	nkbi
佞臣	nkif
宁德	nkde
凝点	nkdm
凝定	nkdk
凝冻	nkds
宁都	nkdu
狞恶	nkee
宁芬	nkff
宁冈	nkgh
宁国	nkgo
宁海	nkhd
宁河	nkhe
凝集	nkji
宁江	nkjl
凝胶	nkjn
宁坤	nkky
宁蒗	nklh
宁陵	nklk
凝眉	nkmw
宁明	nkmk
凝眸	nkmz
凝目	nkmu
宁纳	nkna
宁南	nknj
宁强	nkql
佞人	nkrf
宁日	nkri
宁陕	nkuj
凝思	nksi
宁嗽	nksz
宁帖	nktp
宁武	nkwu
宁县	nkxm
宁馨	nkxb
佞幸	nkxk
凝血	nkxt
宁阳	nkyh
凝注	nkvu
牛蒡	nqbh
扭秤	nqig
牛痘	nqdz
扭断	nqdr
牛倌	nqgr
扭矩	nqju
牛圈	nqjr
牛栏	nqlj
扭力	nqli
纽曼	nqmj
牛虻	nqmg
扭木	nqmu
妞妞	nqnq
牛扒	nqpa
纽襻	nqpj
牛乳	nqru
牛舍	nque
牛瘟	nqwf
牛性	nqxk
牛疫	nqyi
牛蝇	nqyk
牛油	nqyz
纽元	nqyr
牛庄	nqvl
纽卓	nqvo
农安	nsan
农办	nsbj
脓包	nsbc
农大	nsda
农贷	nsdd
弄到	nsdc
农耕	nsgg
农工	nsgs
弄鬼	nsgv
浓黑	nshw
农话	nshx
农会	nshv
弄僵	nsjl
农具	nsju
农垦	nskf
农林	nslb
浓绿	nslv
农贸	nsmc
浓眉	nsmw
农奴	nsnu
脓疱	nspc
弄权	nsqr
农人	nsrf
农桑	nssh
农舍	nsue
脓肾	nsuf
弄通	nsts
弄瓦	nswa
农闲	nsxm
浓香	nsxl
农校	nsxn
脓胸	nsxs
浓须	nsxu
农学	nsxt
脓疡	nsyh
农艺	nsyi
浓荫	nsyb
农用	nsys
农友	nsyz
弄璋	nsvh
农资	nszi
怒潮	nuic
驽钝	nudy
怒放	nufg
弩弓	nugs
怒痕	nuhf
弩机	nuji
怒江	nujl
怒鳞	nulb
怒涛	nutc
怒尾	nuww
怒牙	nuya
怒焰	nuyj
怒羽	nuyu
怒斩	nuvj
怒爪	nuvc
暖道	nrdc
暖阁	nrge
暖锅	nrgo
暖帘	nrlm
暖热	nrre
暖寿	nruz
暖心	nrxb
暖袖	nrxq
虐阴	ntyb
诺安	noan
诺邦	nobh
诺辰	noif
糯稻	nodc
诺恩	noen
诺尔	noer
诺格	noge
诺合	nohe
诺佳	nojx
挪借	nojp
诺康	nokh
诺龙	nols
诺曼	nomj
诺美	nomw
诺沛	nopw
诺其	noqi
诺瑞	norv
诺森	nosf
傩神	nouf
诺爽	noul
诺斯	nosi
诺松	noss
诺特	note
诺通	nots
诺欣	noxb
搦战	novj
诺正	novg
女宝	nvbc
女宾	nvbb
女单	nvdj
女方	nvfg
女官	nvgr
女家	nvjx
女金	nvjb
女角	nvjt
女客	nvke
女垒	nvlw
女气	nvqi
女墙	nvql
女团	nvtr
女校	nvxn
女鞋	nvxp
欧贝	oubw
欧比	oubi
殴斗	oudz
偶犯	oufj
沤肥	oufw
瓯海	ouhd
欧化	ouhx
藕灰	ouhv
偶或	ouho
欧佳	oujx
偶见	oujm
藕节	oujp
欧开	oukk
欧莱	ould
欧力	ouli
欧罗	oulo
欧迈	oumd
欧敏	oumb
欧宁	ounk
欧诺	ouno
偶偶	ouou
偶人	ourf
殴辱	ouru
欧瑞	ourv
藕色	ouse
殴伤	ouuh
欧苏	ousu
欧体	outi
欧维	ouww
欧文	ouwf
呕心	ouxb
瓯绣	ouxq
啪嚓	paia
啪嗒	pada
爬竿	pagj
帕格	page
爬灰	pahv
帕克	pake
爬犁	pali
帕特	pate
帕维	paww
趴窝	pawo
爬泳	pays
帕朱	pavu
排错	pdco
派得	pdde
牌风	pdfg
派格	pdge
派购	pdgz
排洪	pdhs
派活	pdho
排检	pdjm
派款	pdkr
哌喹	pdkv
排涝	pdlc
派林	pdlb
派隆	pdls
牌楼	pdlz
排律	pdlv
拍马	pdma
派蒙	pdmg
牌迷	pdmi
牌面	pdmm
哌能	pdng
排偶	pdou
排炮	pdpc
拍频	pdpb
排枪	pdql
哌嗪	pdqb
派森	pdsf
派纾	pduu
派速	pdsu
排坛	pdtj
派汀	pdtk
派同	pdts
排箫	pdxn
排牙	pdya
排印	pdyb
俳优	pdyz
牌证	pdvg
攀扯	pjie
盘秤	pjig
盘川	pjir
判词	pjci
盘错	pjco
盘道	pjdc
潘德	pjde
判读	pjdu
判分	pjff
攀钢	pjgh
攀供	pjgs
盘桓	pjhr
潘集	pjji
攀交	pjjn
盘锦	pjjb
盘究	pjjq
盘库	pjku
判令	pjlk
叛卖	pjmd
盘弄	pjns
潘诺	pjno
攀爬	pjpa
磐石	pjui
盘梯	pjti
盘条	pjtn
盘陀	pjto
盘县	pjxm
盘牙	pjya
盘运	pjyy
盘账	pjvh
判罪	pjzv
旁出	phiu
庞村	phcy
旁顾	phgu
旁及	phji
旁路	phlu
庞帕	phpa
滂湃	phpd
旁骛	phwu
旁向	phxl
旁坐	phzo
跑表	pcbn
泡茶	pcia
咆齿	pcii
疱疮	pcil
炮打	pcda
庖代	pcdd
跑电	pcdm
跑调	pcdn
庖丁	pcdk
刨根	pcgf
抛荒	pchl
炮灰	pchv
炮姜	pcjl
跑街	pcjp
跑开	pckk
刨坑	pckg
跑酷	pcku
跑垒	pclw
炮楼	pclz
炮烙	pclo
泡囊	pcnh
炮钎	pcqm
抛球	pcqq
跑墒	pcuh
抛射	pcue
抛尸	pcui
刨土	pctu
跑外	pcwd
泡漩	pcxr
炮衣	pcyi
袍泽	pcze
炮竹	pcvu
陪绑	pwbh
胚宝	pwbc
胚柄	pwbk
赔补	pwbu
胚层	pwcg
陪床	pwil
赔错	pwco
陪斗	pwdz
佩尔	pwer
赔话	pwhx
陪考	pwkc
胚孔	pwks
培坤	pwky
佩兰	pwlj
胚膜	pwmo
胚盘	pwpj
胚泡	pwpc
配平	pwpk
配器	pwqi
赔情	pwqk
胚乳	pwru
培瑞	pwrv
配膳	pwuj
陪侍	pwui
配属	pwuu
陪刷	pwux
配体	pwti
辔头	pwtz
配位	pwww
配伍	pwwu
沛县	pwxm
赔笑	pwxn
培修	pwxq
胚芽	pwya
配载	pwzd
配债	pwvd
赔账	pwvh
配子	pwzi
喷笔	pfbi
喷薄	pfbo
湓城	pfig
喷灯	pfdg
喷镀	pfdu
喷放	pffg
盆花	pfhx
喷浆	pfjl
喷酒	pfjq
喷杀	pfua
盆汤	pfth
喷雾	pfwu
喷泻	pfxp
喷液	pfye
蓬安	pgan
篷布	pgbu
烹茶	pgia
鹏程	pgig
膨大	pgda
捧读	pgdu
棚房	pgfg
蓬蒿	pghc
膨化	pghx
硼黄	pghl
棚架	pgjx
蓬江	pgjl
棚圈	pgjr
捧角	pgjt
蓬茸	pgrs
蓬散	pgsj
彭山	pguj
棚舍	pgue
彭水	pguv
硼酸	pgsr
碰锁	pgso
抨弹	pgtj
棚屋	pgwu
蓬溪	pgxi
彭县	pgxm
膨压	pgya
彭阳	pgyh
彭泽	pgze
皮层	picg
辟尘	piif
劈刀	pidc
脾的	pide
疲顿	pidy
脾粉	piff
批购	pigz
皮管	pigr
皮辊	pigy
辟海	pihd
披红	pihs
貔虎	pihu
皮黄	pihl
痞积	piji
皮角	pijn
劈开	pikk
疲困	piky
披览	pilj
坯料	piln
铍铝	pilv
披靡	pimi
纰缪	pimq
皮袍	pipc
皮片	pipm
僻壤	pirh
疲弱	piro
劈杀	piua
坯胎	pitd
皮糖	pith
皮特	pite
劈头	pitz
披屋	piwu
劈胸	pixs
皮影	piyk
僻远	piyr
脾脏	pizh
皮张	pivh
皮重	pivs
邳州	pivz
批转	pivr
皮赘	pivv
偏安	pman
骗财	pmcd
骗贷	pmdd
偏殿	pmdm
偏饭	pmfj
偏废	pmfw
偏关	pmgr
偏光	pmgl
偏航	pmhh
偏护	pmhu
骗汇	pmhv
偏将	pmjl
偏角	pmjn
片警	pmjk
偏劳	pmlc
偏流	pmlq
骗马	pmma
骗卖	pmmd
犏牛	pmnq
骗气	pmqi
偏衫	pmuj
偏生	pmug
偏私	pmsi
片汤	pmth
偏调	pmtn
骈文	pmwf
偏下	pmxx
偏斜	pmxp
偏序	pmxu
片选	pmxr
偏压	pmya
篇页	pmye
片约	pmyt
骗展	pmvj
偏振	pmvf
票车	pnie
飘尘	pnif
漂大	pnda
票额	pnee
飘发	pnfa
票房	pnfg
飘飞	pnfw
票根	pngf
飘海	pnhd
票号	pnhc
漂鸟	pnnn
嫖女	pnnv
瓢泼	pnpo
剽取	pnqu
票券	pnqr
骠勇	pnys
飘欲	pnyu
票源	pnyr
飘展	pnvj
票证	pnvg
票庄	pnvl
撇开	ppkk
苤蓝	pplj
撇弃	ppqi
拼版	pbbj
颦蹙	pbcu
频大	pbda
频带	pbdd
品第	pbdi
频段	pbdr
品红	pbhs
贫化	pbhx
聘金	pbjb
品酒	pbjq
拼卡	pbka
拼客	pbke
贫矿	pbkl
品蓝	pblj
品类	pblw
品目	pbmu
牝牛	pbnq
贫农	pbns
拼配	pbpw
频谱	pbpu
品圈	pbqr
频仍	pbrg
贫弱	pbro
品色	pbse
频数	pbuo
品题	pbti
品脱	pbto
聘问	pbwf
品系	pbxi
频域	pbyu
拼争	pbvg
拼缀	pbvv
品族	pbzu
平白	pkbd
屏边	pkbm
平产	pkij
平车	pkie
平畴	pkiz
平川	pkir
平度	pkdu
评断	pkdr
评功	pkgs
平光	pkgl
平湖	pkhu
平毁	pkhv
评荐	pkjm
平角	pkjn
平津	pkjb
凭靠	pkkc
平克	pkke
平旷	pkkl
平阔	pkko
凭栏	pklj
平乐	pkle
乒联	pklm
平凉	pkll
平聊	pkln
平列	pklp
平流	pklq
平乱	pklr
平罗	pklo
屏门	pkmf
平明	pkmk
平能	pkng
平年	pknm
评聘	pkpb
平桥	pkqn
平绒	pkrs
平射	pkue
平顺	pkuy
平妥	pkto
平武	pkwu
乒协	pkxp
平衍	pkyj
平阳	pkyh
平遥	pkyc
平野	pkye
平阴	pkyb
评优	pkyz
平允	pkyy
平展	pkvj
凭照	pkvc
评传	pkvr
萍踪	pkzs
平足	pkzu
平作	pkzo
破壁	pobi
破冰	pobk
叵测	poce
破钞	poic
坡地	podi
破防	pofg
破击	poji
破军	pojy
破空	poks
泼赖	pold
破浪	polh
破脸	polm
迫临	polb
迫令	polk
破陋	polz
婆母	pomu
破桶	pots
坡头	potz
破土	potu
陂陀	poto
鄱阳	poyh
破野	poye
破影	poyk
破约	poyt
破招	povc
破阵	povf
婆子	pozi
剖白	pzbd
剖解	pzjp
剖开	pzkk
普安	puan
铺板	pubj
蒲棒	pubh
蒲包	pubc
浦北	pubw
谱表	pubn
蒲草	pucc
普测	puce
仆从	pucs
谱牒	pudp
普定	pudk
蒲墩	pudy
扑感	pugj
普格	puge
铺轨	pugv
谱号	puhc
普贺	puhe
朴厚	puhz
铺户	puhu
扑花	puhx
蒲黄	puhl
蒲剑	pujm
蒲剧	puju
普卡	puka
铺开	pukk
浦口	pukz
蒲葵	pukv
普兰	pulj
扑棱	pulg
葡立	puli
蒲柳	pulq
朴茂	pumc
普宁	punk
铺排	pupd
仆仆	pupu
普沁	puqb
蒲绒	purs
普润	pury
谱色	puse
曝晒	puud
铺摊	putj
葡糖	puth
普特	pute
莆田	putm
蒲亭	putk
普秃	putu
谱系	puxi
铺叙	puxu
朴学	puxt
蹼泳	puys
浦优	puyz
蒲郁	puyu
铺展	puvj
朴拙	puvo
旗瓣	qibj
气泵	qibg
气层	qicg
气冲	qiis
蕲春	qiiy
祺达	qida
汽灯	qidg
起稿	qigc
气根	qigf
七古	qigu
起卦	qigx
气锅	qigo
气海	qihd
气焊	qihj
气户	qihu
期考	qikc
耆老	qilc
棋类	qilw
芪龙	qils
气楼	qilz
气脉	qimd
汽暖	qinr
齐诺	qino
杞蓉	qirs
气煞	qiua
奇商	qiuh
起算	qisr
其外	qiwd
起卧	qiwo
奇秀	qixq
气旋	qixr
奇勋	qixy
七曜	qiyc
起赃	qizh
七罪	qizv
洽购	qxgz
髂骨	qxgu
袷袢	qxpj
恰切	qxqp
洽商	qxuh
扦插	qmia
前仇	qmiz
铅锤	qmiv
前唇	qmiy
钱褡	qmda
浅耕	qmgg
钱柜	qmgv
潜航	qmhh
堑壕	qmhc
前胡	qmhu
铅华	qmhx
欠火	qmho
千卡	qmka
钳口	qmkz
铅矿	qmkl
前馈	qmkv
悭吝	qmlb
千灵	qmlk
荨麻	qmma
前茅	qmmc
前脑	qmnc
潜匿	qmni
牵牛	qmnq
签批	qmpi
钱票	qmpn
铅瓶	qmpk
前秦	qmqb
前情	qmqk
前晌	qmuh
谦顺	qmuy
浅说	qmuo
铅丝	qmsi
签筒	qmts
迁葬	qmzh
乾造	qmzc
千针	qmvf
前爪	qmvx
抢白	qlbd
羟胍	qlgx
强将	qljl
呛咳	qlke
蜣螂	qllh
墙裙	qlqy
锖色	qlse
强似	qlsi
强酸	qlsr
枪穗	qlsv
强喜	qlxi
强心	qlxb
强压	qlya
墙垣	qlyr
羌月	qlyt
戕贼	qlzw
抢种	qlvs
乔艾	qnai
峭拔	qnba
侨办	qnbj
撬棒	qnbh
巧辩	qnbm
硗薄	qnbo
壳菜	qncd
谯城	qnig
鞘翅	qnii
乔丹	qndj
乔多	qndz
乔恩	qnen
巧干	qngj
撬杠	qngh
敲鼓	qngu
撬棍	qngy
侨汇	qnhv
俏货	qnho
巧匠	qnjl
侨眷	qnjr
桥孔	qnks
桥栏	qnlj
翘棱	qnlg
侨联	qnlm
谯楼	qnlz
乔尼	qnni
翘盼	qnpj
硗确	qnqt
敲入	qnru
侨商	qnuh
巧事	qnui
桥堍	qntu
翘望	qnwh
侨务	qnwu
桥西	qnxi
俏销	qnxn
锹性	qnxk
窍阴	qnyb
乔贞	qnvf
切比	qpbi
切变	qpbm
挈带	qpdd
切点	qpdm
窃夺	qpdz
切尔	qper
切糕	qpgc
惬怀	qphk
切角	qpjn
切近	qpjb
窃据	qpju
伽蓝	qplj
切力	qpli
窃明	qpmk
且末	qpmo
切盼	qppj
切伤	qpuh
怯逃	qptc
切牙	qpya
切要	qpyc
切音	qpyb
切缘	qpyr
秦安	qban
钦北	qbbw
亲本	qbbf
亲兵	qbbk
寝车	qbie
侵晨	qbif
秦城	qbig
亲代	qbdd
禽蛋	qbdj
亲等	qbdg
揿动	qbds
侵夺	qbdz
寝宫	qbgs
秦淮	qbhk
秦皇	qbhl
琴江	qbjl
秦艽	qbjn
钦敬	qbjk
勤苦	qbku
钦南	qbnj
琴鸟	qbnn
钦诺	qbno
秦皮	qbpi
芩翘	qbqn
禽舍	qbue
沁水	qbuv
秦苏	qbsu
琴亭	qbtk
侵晓	qbxn
侵越	qbyt
钦州	qbvz
秦篆	qbvr
亲族	qbzu
青帮	qkbh
清碧	qkbi
青布	qkbu
情痴	qkii
青川	qkir
清创	qkil
轻锤	qkiv
青葱	qkcs
青黛	qkdd
清党	qkdh
青灯	qkdg
倾动	qkds
青豆	qkdz
青娥	qkee
清肺	qkfw
青冈	qkgh
青蛤	qkha
清寒	qkhj
清酒	qkjq
清俊	qkjy
清口	qkkz
氢醌	qkky
青蓝	qklj
清冷	qklg
清冽	qklp
清流	qklq
晴纶	qkly
轻慢	qkmj
轻帽	qkmc
青梅	qkmw
清蒙	qkmg
青苗	qkmn
倾慕	qkmu
倾囊	qknh
青鸟	qknn
清宁	qknk
轻弩	qknu
轻暖	qknr
清盘	qkpj
倾盆	qkpf
清欠	qkqm
倾腔	qkql
清泉	qkqr
清热	qkre
清润	qkry
倾洒	qksa
清扫	qksc
青山	qkuj
青蛇	qkue
倾塌	qkta
清汤	qkth
轻蹄	qkti
青铜	qkts
清退	qktv
情网	qkwh
倾销	qkxn
清眩	qkxr
轻靴	qkxt
清夜	qkye
清音	qkyb
穹苍	qsch
穷愁	qsiz
穷乏	qsfa
穷根	qsgf
琼海	qshd
穷汉	qshj
琼浆	qsjl
穷究	qsjq
穷寇	qskz
邛崃	qsld
穹庐	qslu
穷忙	qsmh
茕茕	qsqs
琼山	qsuj
穷途	qstu
琼瑶	qsyc
琼脂	qsvi
琼中	qsvs
穷追	qsvv
球摆	qqbd
丘北	qqbw
求成	qqig
球胆	qqdj
求导	qqdc
球儿	qqer
球感	qqgj
秋谷	qqgu
秋灌	qqgr
秋光	qqgl
球果	qqgo
秋毫	qqhc
秋灰	qqhv
秋葵	qqkv
囚牢	qqlc
球面	qqmm
秋末	qqmo
丘墓	qqmu
丘脑	qqnc
求乞	qqqi
求荣	qqrs
秋霜	qqul
球坛	qqtj
求降	qqxl
秋汛	qqxy
仇英	qqyk
球钻	qqzr
曲奥	quao
祛白	qubd
取保	qubc
趋避	qubi
曲鬓	qubb
曲柄	qubk
曲差	quia
祛痘	qudz
区队	qudv
取法	qufa
趋高	qugc
曲骨	qugu
趋光	qugl
趋缓	quhr
去火	quho
阒寂	quji
曲江	qujl
区块	qukk
曲莱	quld
劬劳	qulc
曲率	qulv
瞿麦	qumd
曲纳	quna
取闹	qunc
驱鸟	qunn
去耦	quou
曲牌	qupd
取平	qupk
驱迫	qupo
曲泉	quqr
阒然	qurj
去任	qurf
屈伸	quuf
曲水	quuv
曲松	quss
去岁	qusv
屈枉	quwh
曲沃	quwo
区性	quxk
去雄	quxs
蛆眼	quyj
曲泽	quze
曲针	quvf
曲种	quvs
祛浊	quvo
拳棒	qrbh
全豹	qrbc
泉币	qrbi
权变	qrbm
权标	qrbn
拳参	qrcj
圈操	qrcc
犬齿	qrii
诠次	qrci
全等	qrdg
圈点	qrdm
圈儿	qrer
劝返	qrfj
全份	qrff
泉港	qrgh
颧弓	qrgs
全冠	qrgr
全光	qrgl
劝和	qrhe
颧篌	qrhz
全乎	qrhu
劝化	qrhx
全歼	qrjm
劝进	qrjb
全开	qrkk
权磊	qrlw
拳联	qrlm
全裂	qrlp
泉流	qrlq
圈拢	qrls
全鹿	qrlu
权门	qrmf
全南	qrnj
全篇	qrpm
蜷曲	qrqu
全人	qrrf
全日	qrri
全色	qrse
拳手	qruz
醛酸	qrsr
蜷缩	qrso
拳坛	qrtj
全托	qrto
全休	qrxq
铨叙	qrxu
劝学	qrxt
犬牙	qrya
全音	qryb
泉盈	qryk
权诈	qrva
圈占	qrvj
权杖	qrvh
诠注	qrvu
全传	qrvr
缺编	qtbm
确当	qtdh
却敌	qtdi
缺对	qtdv
缺额	qtee
确复	qtfu
确乎	qthu
确界	qtjp
缺漏	qtlz
缺盆	qtpf
确山	qtuj
炔烃	qttk
瘸腿	qttv
缺血	qtxt
阙疑	qtyi
缺员	qtyr
确证	qtvg
缺嘴	qtzv
裙钗	qyid
群臣	qyif
群雕	qydn
群芳	qyfg
群攻	qygs
群婚	qyhy
群集	qyji
群力	qyli
群论	qyly
群落	qylo
群魔	qymo
群起	qyqi
群舞	qywu
群像	qyxl
逡巡	qyxy
裙装	qyvl
群租	qyzu
染布	rjbu
燃放	rjfg
然谷	rjgu
髯口	rjkz
燃灵	rjlk
燃魔	rjmo
然诺	rjno
燃刃	rjrf
蚺蛇	rjue
燃素	rjsu
燃须	rjxu
攘臂	rhbi
让茶	rhia
攘夺	rhdz
让价	rhjx
嚷叫	rhjn
让开	rhkk
壤塘	rhth
壤土	rhtu
攘外	rhwd
瓤子	rhzi
桡骨	rcgu
饶河	rche
桡箕	rcji
绕接	rcjp
饶平	rcpk
扰攘	rcrh
扰扰	rcrc
饶头	rctz
绕线	rcxm
饶阳	rcyh
绕转	rcvr
绕组	rczu
热泵	rebg
热表	rebn
热病	rebk
热补	rebu
热肠	reih
热堆	redv
热痱	refw
热管	regr
热化	rehx
热机	reji
热价	rejx
热劲	rejb
热觉	rejt
热库	reku
热炉	relu
热敏	remb
热呕	reou
热容	rers
热砂	reua
热伤	reuh
热压	reya
热疫	reyi
热饮	reyb
热源	reyr
热晕	reyy
热轧	reva
热战	revj
热障	revh
热症	revg
热值	revi
热柱	revu
热字	rezi
热阻	rezu
人保	rfbc
任便	rfbm
仁布	rfbu
刃肠	rfih
刃齿	rfii
仁弟	rfdi
忍冬	rfds
人防	rffg
人豪	rfhc
仁怀	rfhk
人寰	rfhr
人祸	rfho
人精	rfjk
刃具	rfju
认捐	rfjr
人狼	rflh
刃鳞	rflb
人伦	rfly
任满	rfmj
人年	rfnm
纫佩	rfpw
韧皮	rfpi
人墙	rfql
认亲	rfqb
人日	rfri
荏弱	rfro
仁苏	rfsu
任所	rfso
人天	rftm
稔湾	rfwj
人望	rfwh
任县	rfxm
刃叶	rfye
认作	rfzo
日戳	riiz
日珥	rier
日工	rigs
日刊	rikj
日来	rild
日怒	rinu
日射	riue
日坛	ritj
日土	ritu
日托	rito
日夕	rixi
日薪	rixb
日影	riyk
日晕	riyy
日臻	rivf
融安	rsan
蓉北	rsbw
冗笔	rsbi
溶出	rsiu
绒带	rsdd
冗繁	rsfj
融会	rshv
溶胶	rsjn
容抗	rskh
熔炼	rslm
溶媒	rsmw
容情	rsqk
绒球	rsqq
溶蚀	rsui
溶栓	rsur
融水	rsuv
熔丝	rssi
绒毯	rstj
荣威	rsww
冗务	rswu
荣心	rsxb
绒绣	rsxq
溶血	rsxt
冗杂	rsza
熔渣	rsva
溶质	rsvi
冗赘	rsvv
肉案	rzan
肉畜	rziu
肉丁	rzdk
柔风	rzfg
肉冠	rzgr
肉桂	rzgv
肉红	rzhs
肉酱	rzjl
肉蔻	rzkz
柔量	rzll
鞣料	rzln
柔曼	rzmj
肉糜	rzmi
肉末	rzmo
肉排	rzpd
肉票	rzpn
肉鳍	rzqi
肉丘	rzqq
柔润	rzry
柔术	rzuu
鞣酸	rzsr
肉痛	rzts
肉头	rztz
肉兔	rztu
肉臀	rzty
肉馅	rzxm
肉羊	rzyh
乳安	ruan
入胞	rubc
汝辈	rubw
蠕变	rubm
乳钵	rubo
入仓	ruch
汝城	ruig
乳齿	ruii
褥疮	ruil
入春	ruiy
褥单	rudj
入队	rudv
如飞	rufw
乳粉	ruff
入伏	rufu
入阁	ruge
乳光	rugl
乳黄	ruhl
入会	ruhv
儒将	rujl
乳康	rukh
入款	rukr
如乐	rule
入理	ruli
儒林	rulb
汝南	runj
乳清	ruqk
入秋	ruqq
乳泉	ruqr
濡染	rurj
蠕蠕	ruru
乳山	ruuj
入射	ruue
乳糖	ruth
褥套	rutc
入团	rutr
入托	ruto
入弯	ruwj
入邪	ruxp
如心	ruxb
乳臭	ruxq
汝阳	ruyh
入药	ruyc
入夜	ruye
入狱	ruyu
儒者	ruve
乳中	ruvs
汝州	ruvz
软材	rrcd
软垫	rrdm
软缎	rrdr
软风	rrfg
软工	rrgs
软和	rrhe
软甲	rrjx
软木	rrmu
软泥	rrni
软皮	rrpi
软片	rrpm
软食	rrui
软糖	rrth
软铁	rrtp
软席	rrxi
软线	rrxm
软鞋	rrxp
软皂	rrzc
软脂	rrvi
瑞安	rvan
瑞白	rvbd
瑞班	rvbj
瑞倍	rvbw
瑞昌	rvih
芮城	rvig
瑞代	rvdd
瑞德	rvde
锐度	rvdu
瑞恩	rven
瑞尔	rver
瑞菲	rvfw
瑞甘	rvgj
瑞高	rvgc
瑞佳	rvjx
锐角	rvjn
瑞金	rvjb
瑞可	rvke
瑞兰	rvlj
瑞雷	rvlw
瑞联	rvlm
锐迈	rvmd
锐矛	rvmc
锐敏	rvmb
瑞能	rvng
瑞尼	rvni
锐宁	rvnk
瑞帕	rvpa
瑞朋	rvpg
瑞平	rvpk
瑞签	rvqm
瑞秦	rvqb
蕤仁	rvrf
瑞日	rvri
锐沙	rvua
瑞杉	rvuj
瑞什	rvuf
瑞素	rvsu
瑞泰	rvtd
瑞坦	rvtj
瑞特	rvte
瑞田	rvtm
瑞婷	rvtk
瑞雯	rvwf
瑞先	rvxm
瑞香	rvxl
瑞新	rvxb
瑞银	rvyb
瑞鹰	rvyk
瑞云	rvyy
枘凿	rvzc
锐增	rvzg
锐爪	rvvc
润博	rybo
润肠	ryih
润丹	rydj
润格	ryge
润喉	ryhz
润洁	ryjp
润津	ryjb
闰秒	rymn
闰盘	rypj
润祺	ryqi
闰日	ryri
润通	ryts
润正	ryvg
润州	ryvz
润资	ryzi
若虫	rois
若夫	rofu
若何	rohe
弱碱	rojm
弱流	rolq
若迈	romd
箬帽	romc
弱女	ronv
若朋	ropg
若奇	roqi
若羌	roql
弱水	rouv
弱酸	rosr
弱位	roww
箬竹	rovu
撒把	saba
撒播	sabo
萨敌	sadi
萨典	sadm
撒刁	sadn
萨丁	sadk
萨恩	saen
萨尔	saer
萨嘎	saga
撒开	sakk
萨拉	sala
撒赖	sald
萨林	salb
萨隆	sals
萨鲁	salu
萨米	sami
萨普	sapu
飒然	sarj
洒扫	sasc
撒施	saui
萨特	sate
萨万	sawj
萨文	sawf
撒种	savs
萨祖	sazu
塞宝	sdbc
塞尺	sdii
塞达	sdda
赛地	sddi
鳃窦	sddz
赛恩	sden
塞而	sder
噻吩	sdff
赛风	sdfg
塞格	sdge
塞规	sdgv
赛罕	sdhj
赛会	sdhv
腮颊	sdjx
塞卡	sdka
塞克	sdke
鳃裂	sdlp
鳃瘘	sdlz
赛纶	sdly
赛明	sdmk
塞宁	sdnk
赛情	sdqk
赛球	sdqq
塞斯	sdsi
赛威	sdww
腮腺	sdxm
赛增	sdzg
塞族	sdzu
噻唑	sdzo
三餐	sjcj
三春	sjiy
三反	sjfj
三废	sjfw
散工	sjgs
三关	sjgr
散光	sjgl
三害	sjhd
散寒	sjhj
三好	sjhc
三河	sjhe
三金	sjjb
三军	sjjy
散开	sjkk
三棱	sjlg
三里	sjli
三链	sjlm
散裂	sjlp
三轮	sjly
三妙	sjmn
三明	sjmk
伞膜	sjmo
三奶	sjnd
三秋	sjqq
散曲	sjqu
毵毵	sjsj
散手	sjuz
散摊	sjtj
三糖	sjth
三萜	sjtp
三乌	sjwu
三相	sjxl
三溴	sjxq
散佚	sjyi
三藏	sjzh
三朝	sjvc
散座	sjzo
桑德	shde
桑格	shge
桑果	shgo
桑林	shlb
丧乱	shlr
桑麻	shma
丧母	shmu
丧权	shqr
桑日	shri
桑塔	shta
丧亡	shwh
桑榆	shyu
扫毒	scdu
扫掠	sclt
扫灭	scmp
扫漂	scpn
臊气	scqi
扫清	scqk
骚人	scrf
搔首	scuz
扫数	scuu
缫丝	scsi
骚体	scti
扫雪	scxt
色标	sebn
色场	seih
色达	seda
色的	sede
瑟登	sedg
色度	sedu
色法	sefa
色粉	seff
色光	segl
色环	sehr
色集	seji
色键	sejm
色戒	sejp
色矩	seju
色觉	sejt
色轮	sely
色码	sema
色盘	sepj
色品	sepb
色球	seqq
色区	sequ
色散	sesj
色听	setk
色温	sewf
色心	sexb
色医	seyi
色圆	seyr
涩滞	sevi
森安	sfan
森德	sfde
森格	sfge
森古	sfgu
森金	sfjb
森警	sfjk
森克	sfke
森然	sfrj
森特	sfte
森郁	sfyu
僧帽	sgmc
僧徒	sgtu
沙坝	uaba
沙城	uaig
沙船	uair
砂槌	uaiv
沙盗	uadc
沙堆	uadv
沙俄	uaee
沙恩	uaen
傻干	uagj
沙岗	uagh
沙怪	uagk
沙河	uahe
沙獾	uahr
杀戒	uajp
沙坑	uakg
砂矿	uakl
沙岭	ualk
沙柳	ualq
纱帽	uamc
沙门	uamf
杉木	uamu
霎那	uana
砂囊	uanh
沙妮	uani
沙怒	uanu
沙鸥	uaou
沙盘	uapj
厦坪	uapk
沙瓤	uarh
杀软	uarr
沙参	uauf
沙田	uatm
砂条	uatn
沙湾	uawj
沙王	uawh
煞尾	uaww
鲨稀	uaxi
歃血	uaxt
痧药	uayc
沙耶	uaye
沙灾	uazd
沙枣	uazc
纱罩	uavc
沙洲	uavz
沙嘴	uazv
晒场	udih
筛分	udff
筛管	udgr
色酒	udjq
晒客	udke
晒台	udtd
晒种	udvs
舢板	ujbj
善本	ujbf
闪播	ujbo
苫布	ujbu
山草	ujcc
山丹	ujdj
扇段	ujdr
闪躲	ujdz
膳费	ujfw
山根	ujgf
山鬼	ujgv
疝环	ujhr
山甲	ujjx
闪空	ujks
山岚	ujlj
栅漏	ujlz
山玫	ujmw
珊娜	ujna
山南	ujnj
疝囊	ujnh
珊妮	ujni
闪念	ujnm
善宁	ujnk
山炮	ujpc
潸然	ujrj
扇入	ujru
闪射	ujue
山苏	ujsu
山塘	ujth
山桃	ujtc
山坞	ujwu
缮写	ujxp
删削	ujxt
山阴	ujyb
山证	ujvg
山嘴	ujzv
上臂	uhbi
熵波	uhbo
上朝	uhic
上唇	uhiy
上冻	uhds
商都	uhdu
上肥	uhfw
上篌	uhhz
上镜	uhjk
上卷	uhjr
上款	uhkr
上栗	uhli
上林	uhlb
商洛	uhlo
商南	uhnj
上皮	uhpi
上墙	uhql
上色	uhud
伤损	uhsy
上推	uhtv
上鞋	uhxp
上照	uhvc
上奏	uhzz
烧包	ucbc
烧柴	ucid
少冲	ucis
烧瓷	ucci
邵东	ucds
哨岗	ucgh
艄公	ucgs
少海	uchd
烧坏	uchk
烧尽	ucjb
绍剧	ucju
少刻	ucke
烧孔	ucks
少蓝	uclj
少礼	ucli
烧料	ucln
少陪	ucpw
烧瓶	ucpk
烧炭	uctj
梢头	uctz
邵武	ucwu
韶秀	ucxq
稍逊	ucxy
烧着	ucve
烧砖	ucvr
涉笔	uebi
舍宾	uebb
舌刺	ueci
蛇岛	uedc
舍弟	uedi
蛇豆	uedz
蛇毒	uedu
设防	uefg
设岗	uegh
赊购	uegz
舌骨	uegu
折耗	uehc
射洪	uehs
蛇黄	uehl
摄魂	uehy
射界	uejp
舍兰	uelj
蛇鳞	uelb
射流	uelq
舍命	uemk
蛇狞	uenk
涉农	uens
射频	uepb
涉枪	ueql
涉禽	ueqb
社群	ueqy
舍瑞	uerv
设若	uero
设色	uese
蛇伤	ueuh
摄生	ueug
舌痛	uets
蛇蜕	uetv
社戏	uexi
舍下	uexx
射阳	ueyh
蛇咬	ueyc
蛇医	ueyi
慑于	ueyu
谁边	uwbm
谁个	uwge
谁人	uwrf
谁谁	uwuw
神笔	ufbi
深刺	ufci
神灯	ufdg
神帝	ufdi
深冬	ufds
审度	ufdz
深翻	uffj
神封	uffg
审改	ufgd
椹果	ufgo
神汉	ufhj
深痕	ufhf
神魂	ufhy
伸开	ufkk
肾康	ufkh
神雷	uflw
深林	uflb
渗流	uflq
渗漏	uflz
深炉	uflu
哂纳	ufna
肾囊	ufnh
伸宁	ufnk
神农	ufns
审片	ufpm
神阙	ufqt
神人	ufrf
参茸	ufrs
神社	ufue
肾衰	ufuk
申说	ufuo
神堂	ufth
申讨	uftc
身条	uftn
深铁	uftp
申屠	uftu
渗析	ufxi
申谢	ufxp
神秀	ufxq
伸腰	ufyc
深泽	ufze
申扎	ufva
胜艾	ugai
圣碑	ugbw
圣餐	ugcj
绳操	ugcc
胜朝	ugic
生凑	ugcz
圣盾	ugdy
升汞	uggs
圣谷	uggu
生桂	uggv
省俭	ugjm
生胶	ugjn
生角	ugjt
圣君	ugjy
盛开	ugkk
声抗	ugkh
生客	ugke
绳缆	uglj
声浪	uglh
生料	ugln
省滦	uglr
升麻	ugma
生脉	ugmd
生煤	ugmw
声门	ugmf
生面	ugmm
圣庙	ugmn
绳墨	ugmo
生奶	ugnd
剩男	ugnj
声囊	ugnh
圣诺	ugno
声旁	ugph
声谱	ugpu
省却	ugqt
生肉	ugrz
圣上	uguh
生身	uguf
升堂	ugth
圣训	ugxy
生业	ugye
生造	ugzc
嵊州	ugvz
盛馔	ugvr
声阻	ugzu
实参	uicj
试产	uiij
试车	uiie
市寸	uicy
石东	uids
食窦	uidz
石碓	uidv
石腭	uiee
施恩	uien
石岗	uigh
实根	uigf
石拐	uigk
石盔	uikv
势垒	uilw
石龙	uils
石楼	uilz
石门	uimf
师奶	uind
市南	uinj
侍弄	uins
势派	uipd
石皮	uipi
世亲	uiqb
失却	uiqt
失群	uiqy
石蕊	uirv
侍僧	uisg
失水	uiuv
石松	uiss
石塔	uita
师训	uixy
释藏	uizh
石渣	uiva
施斋	uivd
实轴	uivz
诗作	uizo
收案	uzan
瘦瘪	uzbp
首部	uzbu
手参	uzcj
收操	uzcc
手锤	uziv
手戳	uziz
手大	uzda
受的	uzde
首钢	uzgh
寿光	uzgl
手黑	uzhw
受窘	uzjs
守军	uzjy
首抗	uzkh
手辣	uzla
受冷	uzlg
售楼	uzlz
收率	uzlv
手慢	uzmj
手民	uzmb
寿宁	uznk
收拍	uzpd
守丧	uzsh
受禅	uzuj
手松	uzss
受胎	uztd
寿堂	uzth
受孕	uzyy
收摘	uzvd
手赵	uzvc
竖版	uubj
舒邦	uubh
梳篦	uubi
书册	uuce
书痴	uuii
舒窗	uuil
鼠窜	uucr
赎当	uudh
舒啶	uudk
书贩	uufj
舒肺	uufw
舒更	uugg
书购	uugz
束骨	uugu
树挂	uugx
沭河	uuhe
书后	uuhz
树胶	uujn
舒康	uukh
疏狂	uukl
蜀葵	uukv
疏阔	uuko
熟料	uuln
树龄	uulk
数论	uuly
舒配	uupw
叔婆	uupo
枢柔	uurz
舒赛	uusd
菽粟	uusu
熟烫	uuth
书套	uutc
书体	uuti
暑天	uutm
熟铁	uutp
暑瘟	uuwf
舒胸	uuxs
舒徐	uuxu
书札	uuva
树种	uuvs
耍奸	uxjm
刷拉	uxla
耍闹	uxnc
耍泼	uxpo
耍钱	uxqm
耍笑	uxxn
摔绊	ukbj
衰惫	ukbw
衰变	ukbm
衰草	ukcc
甩动	ukds
率尔	uker
甩开	ukkk
摔炮	ukpc
帅少	ukuc
衰替	ukti
摔投	uktz
衰歇	ukxp
衰朽	ukxq
甩站	ukvj
栓皮	urpi
涮肉	urrz
栓塞	urse
栓子	urzi
双鬓	ulbb
双倡	ulih
霜晨	ulif
双城	ulig
双川	ulir
双迪	uldi
孀妇	ulfu
双工	ulgs
双钩	ulgz
双拐	ulgk
双轨	ulgv
霜害	ulhd
双湖	ulhu
霜花	ulhx
双环	ulhr
霜火	ulho
双镜	uljk
爽利	ulli
双链	ullm
双流	ullq
双滦	ullr
爽妙	ulmn
霜鸣	ulmk
爽宁	ulnk
双喷	ulpf
爽前	ulqm
双抢	ulql
双桥	ulqn
双清	ulqk
爽然	ulrj
双日	ulri
双山	uluj
双塔	ulta
双糖	ulth
霜天	ultm
霜纹	ulwf
双喜	ulxi
双侠	ulxx
霜须	ulxu
双阳	ulyh
双拥	ulys
双钟	ulvs
双绉	ulvz
霜鬃	ulzs
双座	ulzo
睡安	uvan
水坝	uvba
睡宝	uvbc
水笔	uvbi
水滨	uvbb
水兵	uvbk
水层	uvcg
水床	uvil
水锤	uviv
水葱	uvcs
水貂	uvdn
水痘	uvdz
水碓	uvdv
水缸	uvgh
水歌	uvge
水工	uvgs
水害	uvhd
水旱	uvhj
水红	uvhs
水魂	uvhy
水具	uvju
水军	uvjy
水孔	uvks
水雷	uvlw
水冷	uvlg
水龙	uvls
睡帽	uvmc
水媒	uvmw
水门	uvmf
水南	uvnj
水碾	uvnm
水牌	uvpd
税卡	uvqx
水橇	uvqn
水禽	uvqb
水情	uvqk
水乳	uvru
水色	uvse
水生	uvug
水苏	uvsu
水潭	uvtj
水藤	uvtg
水体	uvti
水涡	uvwo
水样	uvyh
水葬	uvzh
水钻	uvzr
顺铂	uybo
顺城	uyig
顺乎	uyhu
顺列	uylp
顺民	uymb
顺平	uypk
舜日	uyri
瞬闪	uyuj
顺坦	uytj
顺向	uyxl
吮血	uyxp
吮咂	uyza
瞬子	uyzi
说白	uobd
蒴柄	uobk
说定	uodk
朔方	uofg
说开	uokk
朔日	uori
朔望	uowh
朔县	uoxm
朔月	uoyt
朔州	uovz
说嘴	uozv
死别	sibp
四部	sibu
饲草	sicc
私娼	siih
死沉	siif
厮打	sida
死点	sidm
私定	sidk
司铎	sidz
四缝	sifg
丝糕	sigc
寺观	sigr
思过	sigo
四近	sijb
丝卷	sijr
死矿	sikl
斯兰	silj
思恋	silm
四满	simj
思茅	simc
死门	simf
丝米	simi
思谋	simz
私囊	sinh
四逆	sini
四旁	siph
丝袍	sipc
四平	sipk
四强	siql
思亲	siqb
肆扰	sirc
丝绒	sirs
四散	sisj
斯坦	sitj
四藤	sitg
四体	siti
四外	siwd
伺隙	sixi
四消	sixn
四野	siye
死战	sivj
思真	sivf
丝足	sizu
讼案	ssan
菘菜	sscd
送呈	ssig
松脆	sscv
送发	ssfa
宋光	ssgl
讼棍	ssgy
松果	ssgo
松鹤	sshe
松鸡	ssji
松江	ssjl
松萝	sslo
松蘑	ssmo
松潘	sspj
送亲	ssqb
送情	ssqk
松球	ssqq
送入	ssru
送丧	sssh
松塔	ssta
耸听	sstk
松土	sstu
送往	sswh
嵩县	ssxm
松蕈	ssxy
松烟	ssyj
松原	ssyr
送展	ssvj
松针	ssvf
松嘴	sszv
搜保	szbc
艘次	szci
搜检	szjm
搜括	szko
嗾使	szui
搜天	sztm
搜娱	szyu
素安	suan
苏澳	suao
肃北	subw
苏村	sucy
素定	sudk
素缎	sudr
苏恩	suen
肃反	sufj
苏肝	sugj
塑钢	sugh
宿根	sugf
素裹	sugo
苏合	suhe
素篌	suhz
素洁	sujp
苏剧	suju
速卡	suka
苏拉	sula
苏雷	sulw
素瘤	sulq
苏伦	suly
苏曼	sumj
肃南	sunj
肃宁	sunk
素朴	supu
宿迁	suqm
诉权	suqr
素日	suri
素色	suse
苏珊	suuj
俗尚	suuh
苏爽	suul
苏顺	suuy
苏斯	susi
肃贪	sutj
酥糖	suth
俗体	suti
苏铁	sutp
宿土	sutu
苏瓦	suwa
素问	suwf
素席	suxi
速战	suvj
粟疹	suvf
酸败	srbd
蒜瓣	srbj
酸鼻	srbi
算草	srcc
算尺	srii
算得	srde
酸腐	srfu
酸酐	srgj
酸根	srgf
蒜毫	srhc
蒜黄	srhl
酸梅	srmw
酸模	srmo
酸尿	srnn
蒜农	srns
算清	srqk
算题	srti
酸洗	srxi
算学	srxt
酸盐	sryj
算子	srzi
绥滨	svbb
碎冰	svbk
岁差	svia
随带	svdd
绥德	svde
碎腭	svee
燧火	svho
髓角	svjn
绥靖	svjk
碎盔	svkv
碎颅	svlu
碎矛	svmc
岁杪	svmn
髓袢	svpj
遂平	svpk
碎鳍	svqi
随迁	svqm
髓腔	svql
髓鞘	svqn
随群	svqy
岁入	svru
随顺	svuy
随俗	svsu
髓索	svso
随体	svti
随调	svtn
岁晚	svwj
岁尾	svww
岁序	svxu
穗选	svxr
碎牙	svya
碎云	svyy
绥中	svvs
穗子	svzi
孙村	sycy
笋干	sygj
笋瓜	sygx
笋鸡	syji
笋尖	syjm
榫头	sytz
榫眼	syyj
梭镖	sobn
所长	soih
缩尺	soii
索尔	soer
缩放	sofg
锁国	sogo
缩合	sohe
羧基	soji
索解	sojp
缩聚	soju
索克	soke
索拉	sola
索兰	solj
索雷	solw
桫椤	solo
索玛	soma
缩脉	somd
索命	somk
锁模	somo
索宁	sonk
索桥	soqn
索求	soqq
缩泉	soqr
羧酸	sosr
索乌	sowu
琐细	soxi
锁相	soxl
索信	soxb
锁眼	soyj
梭鱼	soyu
锁钥	soyt
索债	sovd
拓本	tabf
塔城	taig
他处	taiu
塔吊	tadn
塔盾	tady
塔恩	taen
塔尔	taer
踏歌	tage
他国	tago
塔河	tahe
塌架	tajx
塔克	take
塔雷	talw
塔林	talb
塔隆	tals
塔楼	talz
塔轮	taly
他年	tanm
拓片	tapm
踏青	taqk
嗒然	tarj
塔特	tate
塔文	tawf
他乡	taxl
塌心	taxb
塔钟	tavs
抬爱	tdai
泰宾	tdbb
太仓	tdch
太冲	tdis
泰顿	tddy
胎发	tdfa
泰戈	tdge
泰来	tdld
台联	tdlm
台盟	tdmg
太庙	tdmn
胎膜	tdmo
泰姆	tdmu
胎囊	tdnh
泰能	tdng
泰尼	tdni
泰诺	tdno
泰瑞	tdrv
泰森	tdsf
台属	tduu
泰水	tduv
泰顺	tduy
泰素	tdsu
泰坦	tdtj
泰特	tdte
苔蹄	tdti
泰托	tdto
泰文	tdwf
泰兴	tdxk
太虚	tdxu
太学	tdxt
泰语	tdyu
台柱	tdvu
台钻	tdzr
探案	tjan
檀板	tjbj
炭笔	tjbi
弹拨	tjbo
坦埠	tjbu
痰喘	tjir
坦德	tjde
贪多	tjdz
探杆	tjgj
碳黑	tjhw
探家	tjjx
叹绝	tjjt
摊开	tjkk
探勘	tjkj
探空	tjks
探马	tjma
探摸	tjmo
坦尼	tjni
坦帕	tjpa
炭盆	tjpf
摊棚	tjpg
弹片	tjpm
探区	tjqu
坦莎	tjua
贪生	tjug
谈说	tjuo
坦斯	tjsi
谈笑	tjxn
炭窑	tjyc
痰饮	tjyb
贪占	tjvj
堂奥	thao
糖棒	thbh
溏便	thbm
唐草	thcc
糖弹	thdj
糖度	thdu
糖萼	thee
堂房	thfg
唐弗	thfu
糖苷	thgj
糖膏	thgc
糖瓜	thgx
躺柜	thgv
唐海	thhd
淌汗	thhj
堂号	thhc
唐河	thhe
唐恒	thhg
汤壶	thhu
堂会	thhv
堂客	thke
镗孔	thks
塘库	thku
糖块	thkk
烫蜡	thla
糖类	thlw
汤料	thln
唐林	thlb
铴锣	thlo
趟马	thma
糖蜜	thmi
塘泥	thni
棠诺	thno
糖球	thqq
汤泉	thqr
倘然	thrj
倘如	thru
唐瑞	thrv
糖色	thud
汤团	thtr
汤碗	thwj
糖稀	thxi
唐笑	thxn
塘堰	thyj
糖业	thye
糖愈	thyu
堂子	thzi
烫嘴	thzv
洮安	tcan
套版	tcbj
洮北	tcbw
逃奔	tcbf
套裁	tccd
套车	tcie
桃城	tcig
讨吃	tcii
绦虫	tcis
桃村	tccy
陶尔	tcer
套房	tcfg
套改	tcgd
套耕	tcgg
陶工	tcgs
套购	tcgz
讨价	tcjx
桃江	tcjl
桃精	tcjk
陶钧	tcjy
套裤	tcku
陶乐	tcle
套链	tclm
淘箩	tclo
套马	tcma
套囊	tcnh
讨平	tcpk
讨巧	tcqn
讨亲	tcqb
讨情	tcqk
套圈	tcqr
套裙	tcqy
陶然	tcrj
逃散	tcsj
套色	tcud
淘神	tcuf
套索	tcso
陶蹄	tcti
套筒	tcts
陶土	tctu
陶瓦	tcwa
套鞋	tcxp
套袖	tcxq
桃汛	tcxy
套印	tcyb
套语	tcyu
讨账	tcvh
套种	tcvs
套作	tczo
特藏	tech
特出	teiu
特恩	teen
特稿	tegc
特护	tehu
特雷	telw
特灵	telk
特命	temk
特纳	tena
特任	terf
特体	teti
特为	teww
特嫌	texm
特诊	tevf
腾冲	tgis
藤刺	tgci
腾达	tgda
藤丹	tgdj
腾房	tgfg
腾贵	tggv
藤黄	tghl
腾克	tgke
誊录	tglu
藤萝	tglo
藤牌	tgpd
藤器	tgqi
誊清	tgqk
藤球	tgqq
腾让	tgrh
腾蛇	tgue
藤蔓	tgwj
藤箱	tgxl
腾涌	tgys
藤杖	tgvh
滕州	tgvz
藤子	tgzi
替班	tibj
踢打	tida
体蒂	tidi
提调	tidn
提尔	tier
提夫	tifu
体改	tigd
剔骨	tigu
题海	tihd
提行	tihh
剔红	tihs
提婚	tihy
蹄筋	tijb
体觉	tijt
提卡	tika
提克	tike
提篮	tilj
涕泪	tilw
体疗	tiln
涕零	tilk
提米	timi
体念	tinm
嚏喷	tipf
体腔	tiql
蹄鞘	tiqn
提挈	tiqp
提请	tiqk
提任	tirf
踢伤	tiuh
体衰	tiuk
踢腾	titg
体悟	tiwu
提讯	tixy
蹄印	tiyb
体针	tivf
体征	tivg
天波	tmbo
田草	tmcc
天车	tmie
田畴	tmiz
天存	tmcy
天等	tmdg
天歌	tmge
天官	tmgr
天昊	tmhc
天痕	tmhf
天火	tmho
天峻	tmjy
填坑	tmkg
填料	tmln
天伦	tmly
甜梦	tmmg
天魔	tmmo
天宁	tmnk
天牛	tmnq
天棚	tmpg
天瀑	tmpu
天穹	tmqs
天球	tmqq
天趣	tmqu
天阙	tmqt
天壤	tmrh
天日	tmri
天容	tmrs
天锐	tmrv
甜润	tmry
天授	tmuz
甜爽	tmul
甜酸	tmsr
天突	tmtu
田娃	tmwa
天溪	tmxi
天阉	tmyj
田阳	tmyh
天影	tmyk
天牖	tmyz
甜枣	tmzc
天择	tmze
天轴	tmvz
田庄	tmvl
天宗	tmzs
天足	tmzu
天尊	tmzy
条案	tnan
调变	tnbm
调测	tnce
条陈	tnif
跳虫	tnis
挑担	tndj
跳荡	tndh
调房	tnfg
调改	tngd
条钢	tngh
跳骨	tngu
条贯	tngr
跳行	tnhh
条痕	tnhf
调护	tnhu
挑花	tnhx
调回	tnhv
调经	tnjk
条口	tnkz
跳链	tnlm
跳梁	tnll
跳鹿	tnlu
髫年	tnnm
佻巧	tnqn
条绒	tnrs
跳伞	tnsj
调摄	tnue
跳神	tnuf
调笑	tnxn
挑眼	tnyj
迢遥	tnyc
调音	tnyb
条桌	tnvo
铁案	tpan
贴边	tpbm
铁铲	tpij
铁厂	tpih
铁笛	tpdi
铁雕	tpdn
铁东	tpds
贴兜	tpdz
铁腭	tpee
铁法	tpfa
铁粉	tpff
铁锋	tpfg
铁镐	tpgc
铁钩	tpgz
铁箍	tpgu
铁管	tpgr
铁耗	tphc
贴合	tphe
铁黑	tphw
铁红	tphs
贴己	tpji
铁栏	tplj
铁力	tpli
铁流	tplq
铁龙	tpls
铁落	tplo
铁马	tpma
铁牛	tpnq
铁怒	tpnu
铁皮	tppi
贴谱	tppu
铁青	tpqk
铁手	tpuz
铁隼	tpsy
铁泰	tptd
铁条	tptn
铁纹	tpwf
铁屑	tpxp
铁须	tpxu
铁衣	tpyi
铁印	tpyb
铁鹰	tpyk
铁羽	tpyu
铁栅	tpva
铁钻	tpzr
葶贝	tkbw
停闭	tkbi
停表	tkbn
停付	tkfu
听骨	tkgu
挺括	tkgx
停航	tkhh
停缓	tkhr
汀角	tkjn
听泡	tkpc
挺入	tkru
听声	tkug
听顺	tkuy
听讼	tkss
停妥	tkto
廷尉	tkww
亭午	tkwu
挺秀	tkxq
停训	tkxy
停药	tkyc
听阈	tkyu
停匀	tkyy
听诊	tkvf
蜓座	tkzo
同奥	tsao
桐柏	tsbd
铜棒	tsbh
童参	tscj
统舱	tsch
通草	tscc
同侪	tsid
统带	tsdd
同调	tsdn
铜锭	tsdk
通分	tsff
铜佛	tsfo
同根	tsgf
同庚	tsgg
通海	tshd
铜焊	tshj
通河	tshe
铜喉	tshz
通解	tsjp
铜矿	tskl
铜绿	tslv
通脉	tsmd
痛宁	tsnk
统配	tspw
同平	tspk
通窍	tsqn
痛切	tsqp
通勤	tsqb
铜圈	tsqr
筒裙	tsqy
通乳	tsru
童伞	tssj
统摄	tsue
通身	tsuf
铜栓	tsur
酮酸	tssr
同堂	tsth
通体	tsti
通条	tstn
筒瓦	tswa
童颜	tsyj
同悦	tsyt
彤云	tsyy
通什	tsza
同种	tsvs
投笔	tzbi
头波	tzbo
头茬	tzia
投拆	tzid
头筹	tziz
头端	tzdr
头伏	tzfu
头盖	tzgd
头功	tzgs
头冠	tzgr
投海	tzhd
透汗	tzhj
投壶	tzhu
头花	tzhx
投江	tzjl
头角	tzjn
头节	tzjp
偷空	tzks
头里	tzli
投料	tzln
头马	tzma
头帽	tzmc
透媚	tzmw
透萌	tzmg
透迷	tzmi
偷摸	tzmo
偷拿	tzna
头年	tznm
头颞	tznp
投枪	tzql
偷巧	tzqn
投亲	tzqb
头球	tzqq
头人	tzrf
头纱	tzua
投书	tzuu
头晚	tzwj
投网	tzwh
头癣	tzxr
投医	tzyi
透雨	tzyu
偷越	tzyt
透照	tzvc
投注	tzvu
投足	tzzu
土坝	tuba
秃笔	tubi
土蚕	tucj
秃疮	tuil
吐翠	tucv
图存	tucy
突地	tude
图段	tudr
图恩	tuen
吐蕃	tufj
土岗	tugh
吐根	tugf
土埂	tugg
屠户	tuhu
途欢	tuhr
涂绘	tuhv
图加	tujx
突进	tujb
图距	tuju
图卷	tujr
土坎	tukj
图克	tuke
吐口	tukz
土块	tukk
土筐	tukl
土狼	tulh
土垒	tulw
兔毛	tumc
图们	tumf
图米	tumi
土牛	tunq
土偶	tuou
秃瓢	tupn
土墙	tuql
土丘	tuqq
突泉	tuqr
土人	turf
徒涉	tuue
涂刷	tuux
吐穗	tusv
凸体	tuti
图婷	tutk
兔脱	tuto
兔心	tuxb
吐絮	tuxu
吐艳	tuyj
土音	tuyb
图元	tuyr
土造	tuzc
团拜	trbd
团部	trbu
彖辞	trci
团岛	trdc
团丁	trdk
湍动	trds
团费	trfw
团粉	trff
团风	trfg
团副	trfu
团徽	trhv
团课	trke
团年	trnm
团弄	trns
团派	trpd
团日	trri
团扇	truj
团校	trxn
团音	tryb
团鱼	tryu
团子	trzi
团坐	trzo
推刨	tvbc
推戴	tvdd
推度	tvdz
退房	tvfg
推服	tvfu
退岗	tvgh
退耕	tvgg
腿甲	tvjx
颓靡	tvmi
退坡	tvpo
推求	tvqq
退热	tvre
颓塌	tvta
推土	tvtu
退团	tvtr
推问	tvwf
推许	tvxu
退养	tvyh
退障	tvvh
推重	tvvs
推注	tvvu
退走	tvzz
吞剥	tybo
臀尖	tyjm
吞克	tyke
屯垦	tykf
囤粮	tyll
屯留	tylq
屯落	tylo
吞灭	tymp
臀鳍	tyqi
臀肉	tyrz
吞声	tyug
屯守	tyuz
豚鼠	tyuu
吞饮	tyyb
臀疣	tyyz
吞云	tyyy
屯扎	tyva
吞占	tyvj
豚脂	tyvi
托安	toan
脱班	tobj
托庇	tobi
拓边	tobm
托病	tobk
拖布	tobu
托槽	tocc
沱茶	toia
拖船	toir
拖带	todd
拖斗	todz
脱毒	todu
托恩	toen
托格	toge
拖挂	togx
托举	toju
妥靠	tokc
托克	toke
脱空	toks
脱硫	tolq
脱漏	tolz
驼鹿	tolu
拖轮	toly
脱盲	tomh
托尼	toni
托派	topd
托平	topk
脱坡	topo
拖腔	toql
脱壳	toqn
脱氢	toqk
椭球	toqq
驼绒	tors
拓赛	tosd
妥实	toui
拖堂	toth
橐驼	toto
拖网	towh
拓文	towf
脱误	towu
拓僖	toxi
妥星	toxk
脱氧	toyh
托幼	toyz
瓦当	wadh
瓦刀	wadc
瓦德	wade
瓦恩	waen
娃儿	waer
瓦格	wage
挖根	wagf
瓦工	wags
瓦灰	wahv
瓦匠	wajl
瓦卡	waka
瓦克	wake
瓦块	wakk
瓦蓝	walj
瓦楞	walg
瓦垄	wals
瓦伦	waly
瓦盆	wapf
挖潜	waqm
瓦圈	waqr
蛙人	warf
蛙声	waug
瓦时	waui
瓦松	wass
袜套	watc
袜筒	wats
瓦头	watz
挖土	watu
洼陷	waxm
外被	wdbw
外差	wdia
歪缠	wdij
外场	wdih
外钞	wdic
外城	wdig
外存	wdcy
外电	wddm
外耳	wder
外感	wdgj
外港	wdgh
外购	wdgz
外海	wdhd
外话	wdhx
外军	wdjy
外刊	wdkj
外空	wdks
外寇	wdkz
外陵	wdlk
外轮	wdly
外脑	wdnc
歪扭	wdnq
外皮	wdpi
外侨	wdqn
外切	wdqp
外倾	wdqk
外丘	wdqq
外圈	wdqr
外水	wduv
外胎	wdtd
外突	wdtu
外推	wdtv
晚材	wjcd
晚场	wjih
晚潮	wjic
晚车	wjie
碗橱	wjiu
畹町	wjdk
顽梗	wjgg
弯钩	wjgz
玩忽	wjhu
万化	wjhx
万籁	wjld
万灵	wjlk
万隆	wjls
腕轮	wjly
玩票	wjpn
弯缺	wjqt
万荣	wjrs
挽手	wjuz
惋叹	wjtj
晚唐	wjth
万汶	wjwf
婉谢	wjxp
万秀	wjxq
万迅	wjxy
万应	wjyk
万载	wjzd
弯折	wjve
万州	wjvz
万状	wjvl
腕足	wjzu
望板	whbj
尪痹	whbi
王波	whbo
旺苍	whch
望穿	whir
王村	whcy
网袋	whdd
望都	whdu
网盾	whdy
网纲	whgh
望海	whhd
王河	whhe
望花	whhx
往还	whhr
旺火	whho
网巾	whjb
望奎	whkv
网篮	whlj
汪里	whli
魍魉	whll
望楼	whlz
网论	whly
王蟒	whmh
望门	whmf
网桥	whqn
王钦	whqb
望色	whse
望厦	whua
网射	whue
亡首	whuz
王水	whuv
妄说	whuo
枉死	whsi
王台	whtd
妄语	whyu
望诊	whvf
网状	whvl
偎傍	wwbh
未便	wwbm
围产	wwij
魏晨	wwif
维春	wwiy
苇丛	wwcs
位错	wwco
苇荡	wwdh
胃的	wwde
位点	wwdm
卫东	wwds
微分	wwff
苇根	wwgf
维宏	wwhs
尾花	wwhx
萎黄	wwhl
卫辉	wwhv
尾矿	wwkl
维拉	wwla
威廉	wwlm
微码	wwma
伪冒	wwmc
微囊	wwnh
胃诺	wwno
韦帕	wwpa
委培	wwpw
维平	wwpk
威迫	wwpo
维普	wwpu
尾欠	wwqm
魏阙	wwqt
胃散	wwsj
胃上	wwuh
唯松	wwss
苇塘	wwth
圩田	wwtm
尾芽	wwya
尾音	wwyb
维英	wwyk
围仔	wwzd
维泽	wwze
围桌	wwvo
温标	wfbn
瘟病	wfbk
稳产	wfij
文昌	wfih
文成	wfig
文丑	wfiz
文唇	wfiy
文登	wfdg
文法	wffa
温服	wffu
文翰	wfhj
温乎	wfhu
文汇	wfhv
温江	wfjl
问津	wfjb
温觉	wfjt
文库	wfku
文侩	wfkk
温岭	wflk
纹缕	wflv
文脉	wfmd
文庙	wfmn
问难	wfnj
文痞	wfpi
文山	wfuj
汶上	wfuh
吻兽	wfuz
温宿	wfsu
稳态	wftd
温汤	wfth
吻突	wftu
文协	wfxp
文言	wfyj
纹样	wfyh
文友	wfyz
文娱	wfyu
文约	wfyt
文宗	wfzs
瓮安	wgan
瓮城	wgig
蓊郁	wgyu
翁源	wgyr
握别	wobp
涡层	wocg
窝巢	woic
卧车	woie
我处	woiu
龌龊	woiz
我党	wodh
卧倒	wodc
我等	wodg
窝洞	wods
沃恩	woen
窝风	wofg
卧佛	wofo
蜗杆	wogj
窝工	wogs
倭瓜	wogx
涡管	wogr
涡环	wohr
涡街	wojp
我军	wojy
沃克	woke
握力	woli
涡流	wolq
沃农	wons
窝棚	wopg
沃平	wopk
沃壤	worh
沃萨	wosa
沃斯	wosi
沃田	wotm
涡线	woxm
沃野	woye
握有	woyz
窝子	wozi
吾侪	wuid
武丑	wuiz
无创	wuil
吴村	wucy
五根	wugf
五更	wugg
武行	wuhh
无恒	wuhg
五荤	wuhy
五绝	wujt
武库	wuku
乌拉	wula
乌兰	wulj
五雷	wulw
五莲	wulm
侮慢	wumj
武庙	wumn
乌木	wumu
乌纳	wuna
无脑	wunc
杌陧	wunp
武平	wupk
舞谱	wupu
乌恰	wuqx
无热	wure
无日	wuri
乌睿	wurv
伍特	wute
武宣	wuxr
五营	wuyk
芜杂	wuza
乌枣	wuzc
伍长	wuvh
无阻	wuzu
仵作	wuzo
戏本	xibf
息兵	xibk
席草	xicc
西侧	xice
铣床	xiil
希存	xicy
翕动	xids
希尔	xier
细高	xigc
吸根	xigf
稀贵	xigv
西黄	xihl
夕晖	xihv
锡匠	xijl
西口	xikz
锡矿	xikl
锡类	xilw
稀料	xiln
西林	xilb
戏楼	xilz
息率	xilv
犀鸟	xinn
西诺	xino
席棚	xipg
系谱	xipu
细巧	xiqn
西泉	xiqr
熙攘	xirh
吸热	xire
息肉	xirz
细润	xiry
洗三	xisj
西晒	xiud
细丝	xisi
细琐	xiso
细谈	xitj
喜帖	xitp
烯烃	xitk
洗选	xixr
息韵	xiyy
吸着	xive
洗濯	xivo
系综	xizs
下辈	xxbw
虾兵	xxbk
下操	xxcc
夏朝	xxic
下宠	xxis
下船	xxir
下唇	xxiy
下挫	xxco
下地	xxdi
夏恩	xxen
遐迩	xxer
下工	xxgs
下锅	xxgo
峡口	xxkz
下款	xxkr
夏琳	xxlb
下陆	xxlu
夏卵	xxlr
下轮	xxly
夏末	xxmo
下木	xxmu
下奶	xxnd
虾皮	xxpi
下欠	xxqm
下情	xxqk
下丘	xxqq
下帖	xxtp
瞎信	xxxb
下院	xxyr
下诏	xxvc
瞎抓	xxvx
线表	xmbn
舷波	xmbo
闲步	xmbu
线虫	xmis
舷窗	xmil
闲荡	xmdh
氙灯	xmdg
限电	xmdm
掀动	xmds
馅儿	xmer
县份	xmff
腺苷	xmgj
弦歌	xmge
险工	xmgs
鲜果	xmgo
衔恨	xmhf
线角	xmjn
掀开	xmkk
先抗	xmkh
陷坑	xmkg
闲空	xmks
线缆	xmlj
仙林	xmlb
鲜绿	xmlv
陷门	xmmf
先民	xmmb
腺泡	xmpc
藓皮	xmpi
先强	xmql
纤巧	xmqn
险球	xmqq
显荣	xmrs
先瑞	xmrv
衔铁	xmtp
闲庭	xmtk
线图	xmtu
线袜	xmwa
先王	xmwh
嫌恶	xmwu
猃狁	xmyy
嫌憎	xmzg
险诈	xmva
险种	xmvs
线轴	xmvz
相帮	xlbh
箱包	xlbc
镶带	xldd
象点	xldm
响度	xldu
香榧	xlfw
香瓜	xlgx
乡宦	xlhr
向猎	xllp
响铃	xllk
响锣	xllo
相瞒	xlmj
向南	xlnj
香囊	xlnh
乡宁	xlnk
香浓	xlns
相碰	xlpg
象频	xlpb
响枪	xlql
湘桥	xlqn
相扰	xlrc
向日	xlri
香薷	xlru
相若	xlro
降顺	xluy
相送	xlss
相态	xltd
香藤	xltg
乡野	xlye
香泽	xlze
橡爪	xlvc
香足	xlzu
小艾	xnai
啸傲	xnao
小报	xnbc
效标	xnbn
小步	xnbu
小差	xnid
小产	xnij
小春	xniy
消痤	xnco
小旦	xndj
销钉	xndk
肖恩	xnen
孝感	xngj
校歌	xnge
小褂	xngx
小乖	xngk
消光	xngl
小舅	xnjq
小考	xnkc
硝喹	xnkv
晓岚	xnlj
小鳞	xnlb
小龙	xnls
淆乱	xnlr
消朦	xnmg
消泯	xnmb
小囊	xnnh
小脑	xnnc
小鲵	xnni
小年	xnnm
晓宁	xnnk
小农	xnns
小胖	xnph
小漂	xnpn
小瓶	xnpk
霄壤	xnrh
萧森	xnsf
消栓	xnur
消损	xnsy
小体	xnti
小洼	xnwa
笑纹	xnwf
小我	xnwo
小修	xnxq
校训	xnxy
小寨	xnvd
小照	xnvc
校整	xnvg
小舟	xnvz
小庄	xnvl
小酌	xnvo
小宗	xnzs
鞋帮	xpbh
写本	xpbf
谢病	xpbk
谐波	xpbo
缬草	xpcc
谢忱	xpif
蝎虫	xpis
卸船	xpir
些个	xpge
歇工	xpgs
协管	xpgr
邪光	xpgl
颉颃	xphh
斜嵴	xpji
泄劲	xpjb
携眷	xpjr
谢军	xpjy
血块	xpkk
偕老	xplc
斜楞	xplg
鞋脸	xplm
歇凉	xpll
泻流	xplq
谐美	xpmw
蟹苗	xpmn
邪僻	xppi
蝎钳	xpqm
蟹青	xpqk
邪泉	xpqr
谢却	xpqt
泻热	xpre
蟹肉	xprz
斜疝	xpuj
鞋刷	xpux
泄水	xpuv
邪祟	xpsv
写锁	xpso
谢帖	xptp
泻停	xptk
蝎王	xpwh
卸运	xpyy
卸责	xpze
邪咒	xpvz
蟹爪	xpvx
锌白	xbbd
新宾	xbbb
新茶	xbia
心传	xbir
信从	xbcs
心存	xbcy
辛达	xbda
心胆	xbdj
心定	xbdk
新法	xbfa
新寡	xbgx
新红	xbhs
新胡	xbhu
心怀	xbhk
心火	xbho
新军	xbjy
欣快	xbkk
新龙	xbls
新罗	xblo
新麻	xbma
囟门	xbmf
新密	xbmi
新苗	xbmn
新民	xbmb
信女	xbnv
信皮	xbpi
新平	xbpk
心魄	xbpo
欣山	xbuj
新邵	xbuc
心衰	xbuk
欣坦	xbtj
新特	xbte
新万	xbwj
信邪	xbxp
心音	xbyb
信友	xbyz
新张	xbvh
兴安	xkan
性比	xkbi
形变	xkbm
星表	xkbn
行波	xkbo
刑部	xkbu
形参	xkcj
省察	xkia
星虫	xkis
性导	xkdc
星等	xkdg
杏丁	xkdk
型钢	xkgh
行贾	xkgu
型管	xkgr
兴国	xkgo
行将	xkjl
行劫	xkjp
醒觉	xkjt
行楷	xkkk
行猎	xklp
醒脑	xknc
兴宁	xknk
形旁	xkph
行聘	xkpb
兴平	xkpk
形钳	xkqm
行腔	xkql
行商	xkuh
行首	xkuz
性损	xksy
行唐	xkth
星特	xkte
刑庭	xktk
星图	xktu
星团	xktr
星协	xkxp
行选	xkxr
兴学	xkxt
刑讯	xkxy
星雅	xkya
荥阳	xkyh
形影	xkyk
行诈	xkva
星展	xkvj
行舟	xkvz
星坠	xkvv
雄才	xscd
雄大	xsda
胸带	xsdd
胸的	xsde
雄飞	xsfw
胸骨	xsgu
熊怪	xsgk
雄关	xsgr
雄豪	xshc
雄核	xshe
凶横	xshg
雄黄	xshl
胸甲	xsjx
雄杰	xsjp
胸卡	xska
凶狂	xskl
胸廓	xsko
凶狼	xslh
雄丽	xsli
胸闷	xsmf
胸膜	xsmo
熊宁	xsnk
雄牛	xsnq
熊肉	xsrz
雄蕊	xsrv
胸水	xsuv
凶死	xssi
熊头	xstz
雄图	xstu
胸臆	xsyi
胸椎	xsvv
朽败	xqbd
锈病	xqbk
秀城	xqig
锈锤	xqiv
修道	xqdc
绣工	xqgs
休玛	xqma
朽迈	xqmd
休宁	xqnk
绣品	xqpb
秀润	xqry
修水	xquv
修文	xqwf
绣鞋	xqxp
岫岩	xqyj
秀英	xqyk
秀洲	xqvz
叙别	xubp
徐步	xubu
续订	xudk
许多	xudz
絮烦	xufj
需方	xufg
须根	xugf
絮聒	xugo
叙话	xuhx
虚骄	xujn
虚礼	xuli
蓄能	xung
序偶	xuou
虚盘	xupj
溆浦	xupu
畜禽	xuqb
恤衫	xuuj
虚态	xutd
许霆	xutk
徐图	xutu
徐晓	xuxn
须癣	xuxr
虚造	xuzc
徐绽	xuvj
絮状	xuvl
轩昂	xrah
选报	xrbc
选本	xrbf
萱草	xrcc
悬揣	xrik
选词	xrci
悬带	xrdd
选点	xrdm
悬吊	xrdn
宣恩	xren
悬隔	xrge
悬河	xrhe
玄黄	xrhl
眩惑	xrho
选件	xrjm
宣讲	xrjl
癣净	xrjk
癣康	xrkh
选矿	xrkl
轩朗	xrlh
旋裂	xrlp
旋轮	xrly
玄秘	xrmi
玄冥	xrmk
选磨	xrmo
悬拟	xrni
选聘	xrpb
玄青	xrqk
选色	xrse
玄参	xruf
玄铁	xrtp
宣统	xrts
宣威	xrww
选型	xrxk
玄虚	xrxu
悬液	xrye
玄影	xryk
选优	xryz
选育	xryu
喧杂	xrza
玄奘	xrzh
喧噪	xrzc
宣战	xrvj
玄锥	xrvv
学霸	xtba
血贝	xtbw
血肠	xtih
血沉	xtif
血仇	xtiz
血槌	xtiv
雪胆	xtdj
血帆	xtfj
削钢	xtgh
血供	xtgs
雪狗	xtgz
削骨	xtgu
雪怪	xtgk
雪光	xtgl
学棍	xtgy
血喉	xthz
血虎	xthu
血环	xthr
学刊	xtkj
血康	xtkh
血口	xtkz
血疗	xtln
血鳞	xtlb
雪盲	xtmh
血膜	xtmo
血怒	xtnu
学区	xtqu
雪融	xtrs
血煞	xtua
血神	xtuf
雪松	xtss
血藤	xttg
雪王	xtwh
血眼	xtyj
血药	xtyc
血印	xtyb
血影	xtyk
学友	xtyz
血藻	xtzc
血肿	xtvs
血咒	xtvz
血钻	xtzr
寻访	xyfg
寻根	xygf
训诂	xygu
巡海	xyhd
熏黑	xyhw
寻呼	xyhu
巡检	xyjm
旬刊	xykj
逊克	xyke
驯狼	xylh
勋劳	xylc
驯良	xyll
训令	xylk
寻龙	xyls
熏木	xymu
旬日	xyri
巡山	xyuj
巡哨	xyuc
寻声	xyug
驯熟	xyuu
驯顺	xyuy
寻索	xyso
迅蹄	xyti
迅通	xyts
寻乌	xywu
浚县	xyxm
迅影	xyyk
训责	xyze
巡诊	xyvf
熏蒸	xyvg
寻踪	xyzs
牙白	yabd
雅邦	yabh
崖壁	yabi
亚伯	yabo
亚布	yabu
牙碜	yaif
压秤	yaig
压船	yair
牙雕	yadn
压顶	yadk
亚东	yads
压队	yadv
压盖	yagd
牙弓	yags
崖谷	yagu
压焊	yahj
牙合	yahe
牙花	yahx
鸭黄	yahl
押汇	yahv
牙尖	yajm
压卷	yajr
压觉	yajt
压库	yaku
压裂	yalp
芽鳞	yalb
牙瘤	yalq
亚伦	yaly
牙面	yamm
鸭苗	yamn
亚明	yamk
亚目	yamu
牙囊	yanh
牙胚	yapw
雅屏	yapk
雅气	yaqi
压强	yaql
雅瑞	yarv
雅森	yasf
压伤	yauh
亚什	yauf
押题	yati
压条	yatn
牙挺	yatk
押尾	yaww
雅文	yawf
雅相	yaxl
压邪	yaxp
亚旭	yaxu
哑哑	yaya
鸦影	yayk
雅乐	yayt
鸦爪	yavc
雅正	yavg
亚种	yavs
牙钻	yazr
烟霭	yjai
赝本	yjbf
岩参	yjcj
岩层	yjcg
延丹	yjdj
烟杆	yjgj
眼高	yjgc
盐工	yjgs
咽康	yjkh
烟岚	yjlj
宴乐	yjle
眼棱	yjlg
盐鳞	yjlb
淹留	yjlq
厌腻	yjni
延年	yjnm
烟农	yjns
艳女	yjnv
眼泡	yjpc
炎鹏	yjpg
验票	yjpn
延平	yjpk
炎日	yjri
颜容	yjrs
盐商	yjuh
眼梢	yjuc
雁塔	yjta
盐亭	yjtk
烟筒	yjts
衍文	yjwf
言笑	yjxn
眼压	yjya
艳友	yjyz
言责	yjze
雁阵	yjvf
阳白	yhbd
漾濞	yhbi
洋布	yhbu
养蚕	yhcj
阳池	yhii
羊胆	yhdj
阳电	yhdm
羊掉	yhdn
羊痘	yhdz
养肺	yhfw
羊肝	yhgj
佯攻	yhgs
阳谷	yhgu
养汉	yhhj
羊毫	yhhc
阳痕	yhhf
洋红	yhhs
洋槐	yhhk
洋灰	yhhv
洋井	yhjk
羊圈	yhjr
痒觉	yhjt
羊口	yhkz
佯狂	yhkl
阳蕾	yhlw
养廉	yhlm
阳鳞	yhlb
养路	yhlu
洋马	yhma
佯谬	yhmq
羊膜	yhmo
杨念	yhnm
洋奴	yhnu
阳坡	yhpo
洋钱	yhqm
扬琴	yhqb
阳曲	yhqu
阳泉	yhqr
怏然	yhrj
阳伞	yhsj
佯射	yhue
杨桃	yhtc
样条	yhtn
洋铁	yhtp
阳虚	yhxu
养血	yhxt
阳叶	yhye
阳原	yhyr
痒疹	yhvf
养正	yhvg
扬中	yhvs
窑变	ycbm
遥测	ycce
药茶	ycia
摇车	ycie
药单	ycdj
尧都	ycdu
妖风	ycfg
邀功	ycgs
妖鬼	ycgv
摇撼	ychj
腰厚	ychz
腰花	ychx
夭矫	ycjn
窑姐	ycjp
药具	ycju
窑坑	yckg
妖狼	yclh
药量	ycll
摇落	yclo
妖牛	ycnq
药农	ycns
药铺	ycpu
杳然	ycrj
妖煞	ycua
咬舌	ycue
幺旋	ycxr
药学	ycxt
摇漾	ycyh
鹞鹰	ycyk
药渣	ycva
腰斩	ycvj
肴馔	ycvr
咬嘴	yczv
页表	yebn
叶柄	yebk
叶城	yeig
页池	yeii
腋臭	yeiz
液氮	yedj
野德	yede
叶盾	yedy
夜饭	yefj
夜工	yegs
夜航	yehh
叶猴	yehz
野菊	yeju
野狼	yelh
液冷	yelg
叶轮	yely
叶脉	yemd
爷娘	yenl
夜宁	yenk
液泡	yepc
野禽	yeqb
夜深	yeuf
夜谈	yetj
野味	yeww
野熊	yexs
椰枣	yezc
腋杖	yevh
页帧	yevf
液汁	yevi
液状	yevl
叶足	yezu
一刹	yiia
蚁巢	yiic
翌晨	yiif
乙丑	yiiz
臆度	yidz
伊恩	yien
议决	yijt
遗老	yilc
逸乐	yile
益诺	yino
依琼	yiqs
义赛	yisd
意舍	yiue
沂水	yiuv
乙酸	yisr
依特	yite
伊瓦	yiwa
遗赠	yizg
印本	ybbf
银冰	ybbk
阴曹	ybcc
饮弹	ybdj
阴电	ybdm
银锭	ybdk
吟哦	ybee
阴干	ybgj
殷钢	ybgh
因格	ybge
音轨	ybgv
银海	ybhd
银红	ybhs
银狐	ybhu
银黄	ybhl
印客	ybke
银空	ybks
音笼	ybls
引论	ybly
荫棚	ybpg
饮片	ybpm
银钱	ybqm
音强	ybql
音容	ybrs
隐射	ybue
瘾头	ybtz
银团	ybtr
引物	ybwu
银州	ybvz
音缀	ybvv
银鬃	ybzs
硬癌	ykai
硬板	ykbj
营部	ykbu
膺窗	ykil
应从	ykcs
影调	ykdn
硬顶	ykdk
硬腭	ykee
应否	ykfz
硬骨	ykgu
瀛寰	ykhr
营口	ykkz
营垒	yklw
英两	ykll
影林	yklb
硬瘤	yklq
应龙	ykls
盈满	ykmj
影矛	ykmc
蝇拍	ykpd
硬皮	ykpi
硬壳	ykqn
迎亲	ykqb
影刃	ykrf
莹润	ykry
营私	yksi
迎送	ykss
盈泰	yktd
硬糖	ykth
影牙	ykya
应诊	ykvf
颍州	ykvz
影踪	ykzs
永安	ysan
壅蔽	ysbi
涌潮	ysic
永城	ysig
永川	ysir
永德	ysde
永登	ysdg
永定	ysdk
用饭	ysfj
用费	ysfw
永丰	ysfg
勇悍	yshj
永和	yshe
永红	yshs
咏怀	yshk
永嘉	ysjx
永靖	ysjk
拥军	ysjy
永康	yskh
涌浪	yslh
泳联	yslm
涌流	yslq
咏梅	ysmw
用命	ysmk
永年	ysnm
永平	yspk
永清	ysqk
永泰	ystd
永望	yswh
永修	ysxq
永夜	ysye
永颖	ysyk
永州	ysvz
油泵	yzbg
油藏	yzch
油茶	yzia
邮车	yzie
釉丛	yzcs
幼蜂	yzfg
优抚	yzfu
油港	yzgh
油膏	yzgc
有恒	yzhg
有奖	yzjl
尤卡	yzka
油料	yzln
邮迷	yzmi
犹纳	yzna
幼嫩	yznf
优宁	yznk
幽僻	yzpi
邮品	yzpb
诱迫	yzpo
优柔	yzrz
有数	yzuu
油刷	yzux
油松	yzss
油酸	yzsr
釉陶	yztc
由头	yztz
优选	yzxr
游学	yzxt
有孕	yzyy
幽真	yzvf
瘀斑	yubj
御笔	yubi
雨辰	yuif
育雏	yuiu
雨锤	yuiv
窳惰	yudz
预防	yufg
育肥	yufw
誉衡	yuhg
于洪	yuhs
羽魂	yuhy
遇救	yujq
鱼口	yukz
迂阔	yuko
遇剌	yula
驭狼	yulh
雨涝	yulc
愚陋	yulz
羽芒	yumh
愚蒙	yumg
芋艿	yund
宇内	yunw
阈能	yung
裕宁	yunk
郁怒	yunu
鱼片	yupm
玉桥	yuqn
余切	yuqp
玉泉	yuqr
鱼群	yuqy
裕如	yuru
雨刷	yuux
羽坛	yutj
熨帖	yutp
毓婷	yutk
愈通	yuts
雨蛙	yuwa
愚顽	yuwj
余姚	yuyc
鱼油	yuyz
御者	yuve
预征	yuvg
鱼子	yuzi
援笔	yrbi
圆雕	yrdn
远端	yrdr
原发	yrfa
圆管	yrgr
圆号	yrhc
源汇	yrhv
原矿	yrkl
远浪	yrlh
源流	yrlq
元麦	yrmd
元秘	yrmi
原棉	yrmm
怨女	yrnv
怨偶	yrou
原平	yrpk
元日	yrri
远山	yruj
圆熟	yruu
渊薮	yrsz
元坦	yrtj
原汤	yrth
元汀	yrtk
元婴	yryk
援用	yrys
援藏	yrzh
月半	ytbj
悦博	ytbo
月产	ytij
越城	ytig
乐段	ytdr
月风	ytfg
约根	ytgf
约翰	ythj
月痕	ythf
月湖	ythu
月环	ythr
月火	ytho
月角	ytjn
跃进	ytjb
月考	ytkc
约拉	ytla
月林	ytlb
乐律	ytlv
跃马	ytma
月矛	ytmc
月怒	ytnu
月琴	ytqb
月刃	ytrf
月神	ytuf
岳塘	ytth
悦亭	yttk
月翼	ytyi
乐音	ytyb
月影	ytyk
云安	yyan
云豹	yybc
运笔	yybi
晕场	yyih
匀兑	yydv
晕光	yygl
匀和	yyho
韵脚	yyjn
云锦	yyjb
匀净	yyjk
孕康	yykh
云林	yylb
匀溜	yylq
云门	yymf
云梦	yymg
陨灭	yymp
孕囊	yynh
云霓	yyni
晕宁	yynk
云珀	yypo
云杉	yyuj
殒身	yyuf
陨铁	yytp
孕酮	yyts
云头	yytz
云图	yytu
云团	yytr
云崖	yyya
云阳	yyyh
云瑶	yyyc
孕照	yyvc
晕针	yyvf
杂病	zabk
杂凑	zacz
咋的	zade
杂多	zadz
咋个	zage
砸锅	zago
扎紧	zajb
杂面	zamm
咂摸	zamo
杂木	zamu
杂品	zapb
扎染	zarj
杂糅	zarz
杂书	zauu
杂说	zauo
杂沓	zata
杂用	zays
杂院	zayr
杂症	zavg
载波	zdbo
在朝	zdic
甾醇	zdiy
再发	zdfa
再犯	zdfj
载荷	zdhe
在教	zdjn
载量	zdll
再林	zdlb
载频	zdpb
再奇	zdqi
再审	zduf
再通	zdts
在途	zdtu
载文	zdwf
在心	zdxb
载运	zdyy
在在	zdzd
糌粑	zjba
赞词	zjci
暂短	zjdr
赞恩	zjen
赞和	zjhe
簪花	zjhx
赞皇	zjhl
赞金	zjjb
赞佩	zjpw
簪缨	zjyk
赞扎	zjva
藏北	zhbw
葬地	zhdi
脏腑	zhfu
脏弓	zhgs
藏蓝	zhlj
脏连	zhlm
脏颅	zhlu
葬埋	zhmd
脏囊	zhnh
脏腔	zhql
藏青	zhqk
脏土	zhtu
脏碗	zhwj
藏戏	zhxi
藏香	zhxl
赃证	zhvg
皂白	zcbd
糟鼻	zcbi
造表	zcbn
早潮	zcic
早车	zcie
皂甙	zcdd
早读	zcdu
造端	zcdr
枣儿	zcer
造粉	zcff
皂苷	zcgj
皂盒	zche
皂户	zchu
早慧	zchv
灶火	zcho
皂角	zcjn
灶君	zcjy
藻类	zclw
造粒	zcli
造林	zclb
早萌	zcmg
枣木	zcmu
枣泥	zcni
皂片	zcpm
灶神	zcuf
早霜	zcul
皂素	zcsu
造田	zctm
灶头	zctz
早秃	zctu
糟心	zcxb
糟朽	zcxq
枣庄	zcvl
蚤缀	zcvv
责编	zebm
泽当	zedh
泽菲	zefw
责分	zeff
泽国	zego
择交	zejn
泽库	zeku
择邻	zelb
择明	zemk
泽姆	zemu
泽宁	zenk
泽普	zepu
择取	zequ
泽荣	zers
择泰	zetd
泽田	zetm
泽通	zets
择校	zexn
泽泻	zexp
择选	zexr
泽州	zevz
怎的	zfde
怎地	zfdi
怎生	zfug
赠别	zgbp
增城	zgig
增调	zgdn
增订	zgdk
增多	zgdz
增辉	zghv
增肌	zgji
增开	zgkk
增刊	zgkj
赠款	zgkr
增亏	zgkv
增乳	zgru
憎世	zgui
赠书	zguu
增温	zgwf
增压	zgya
增液	zgye
增益	zgyi
增盈	zgyk
增重	zgvs
闸北	vabw
诈病	vabk
闸阀	vafa
轧钢	vagh
炸糕	vagc
轧辊	vagy
闸盒	vahe
扎花	vahx
栅距	vaju
扎克	vake
闸口	vakz
扎拉	vala
闸淋	valb
扎玛	vama
扎囊	vanh
闸皮	vapi
扎普	vapu
乍然	varj
痄腮	vasd
札威	vaww
炸窝	vawo
扎约	vayt
扎祖	vazu
扎佐	vazo
摘报	vdbc
择菜	vdcd
摘登	vddg
债额	vdee
摘发	vdfa
摘桂	vdgv
债户	vdhu
摘客	vdke
翟凌	vdlk
斋期	vdqi
宅舍	vdue
斋堂	vdth
择席	vdxi
摘译	vdyi
展板	vjbj
沾城	vjig
詹恩	vjen
战功	vjgs
展柜	vjgv
湛河	vjhe
战痕	vjhf
展缓	vjhr
战甲	vjjx
展宽	vjkr
粘蜡	vjla
展廊	vjlh
毡帽	vjmc
占梦	vjmg
战幕	vjmu
站内	vjnw
斩破	vjpo
栈桥	vjqn
沾亲	vjqb
湛清	vjqk
战刃	vjrf
站哨	vjuc
展团	vjtr
战熊	vjxs
占压	vjya
展演	vjyj
谵语	vjyu
战云	vjyy
掌班	vhbj
障蔽	vhbi
掌鞭	vhbm
杖柄	vhbk
张弛	vhii
张店	vhdm
章动	vhds
掌舵	vhdz
章缝	vhfg
张挂	vhgx
彰化	vhhx
仗剑	vhjm
长角	vhjn
张竣	vhjy
张开	vhkk
长脸	vhlm
胀泡	vhpc
漳平	vhpk
漳浦	vhpu
长亲	vhqb
章丘	vhqq
樟树	vhuu
张爽	vhul
涨水	vhuv
张湾	vhwj
掌纹	vhwf
张夏	vhxx
张悬	vhxr
长眼	vhyj
张掖	vhye
掌印	vhyb
章则	vhze
漳州	vhvz
照壁	vcbi
着边	vcbm
找补	vcbu
赵村	vccy
照登	vcdg
肇东	vcds
照度	vcdu
昭告	vcgc
沼光	vcgl
照海	vchd
沼精	vcjk
昭觉	vcjt
罩盔	vckv
朝露	vclu
着忙	vcmh
照闷	vcmf
招纳	vcna
兆欧	vcou
罩袍	vcpc
罩棚	vcpg
招亲	vcqb
昭然	vcrj
朝日	vcri
罩衫	vcuj
照烧	vcuc
昭通	vcts
兆瓦	vcwa
兆威	vcww
罩衣	vcyi
照用	vcys
招灾	vczd
照准	vcvy
浙贝	vebw
折刀	vedc
这等	vedg
折兑	vedv
褶积	veji
辄筋	vejb
遮瞒	vemj
着呢	vene
褶裙	veqy
柘荣	vers
折伞	vesj
折寿	veuz
折损	vesy
蔗田	vetm
者兔	vetu
折页	veye
折椅	veyi
遮荫	veyb
蔗渣	veva
折纸	vevi
折转	vevr
这里	vwli
镇巴	vfba
诊病	vfbk
震波	vfbo
真纯	vfiy
珍存	vfcy
震达	vfda
珍黛	vfdd
鸩毒	vfdu
阵儿	vfer
镇宫	vfgs
针箍	vfgu
针管	vfgr
真果	vfgo
镇海	vfhd
真核	vfhe
珍红	vfhs
振簧	vfhl
镇魂	vfhy
镇康	vfkh
镇咳	vfke
镇赉	vfld
珍良	vfll
振铃	vflk
振龙	vfls
甄录	vflu
帧率	vflv
针麻	vfma
诊脉	vfmd
镇明	vfmk
镇宁	vfnk
贞女	vfnv
珍哌	vfpd
真确	vfqt
真人	vfrf
镇日	vfri
真瑞	vfrv
贞淑	vfuu
侦听	vftk
珍闻	vfwf
侦讯	vfxy
针药	vfyc
真银	vfyb
震岳	vfyt
正安	vgan
正旦	vgdj
正东	vgds
整儿	vger
争锋	vgfg
征管	vggr
正氦	vghd
争衡	vghg
正话	vghx
正火	vgho
正蓝	vglj
争脸	vglm
整料	vgln
整淋	vglb
蒸馍	vgmo
征募	vgmu
争闹	vgnc
证奴	vgnu
正碰	vgpg
正片	vgpm
正切	vgqp
正瑞	vgrv
争胜	vgug
正态	vgtd
正营	vgyk
证章	vgvh
争嘴	vgzv
正座	vgzo
职别	vibp
支差	viid
之槌	viiv
制动	vids
指端	vidr
之盾	vidy
吱嘎	viga
滞港	vigh
值更	vigg
织火	viho
织就	vijq
治军	vijy
芝兰	vilj
痔漏	vilz
枝蔓	vimj
致盲	vimh
制帽	vimc
酯酶	vimw
致密	vimi
植苗	vimn
滞泥	vini
鸷鸟	vinn
痔宁	vink
支农	vins
之袍	vipc
织染	virj
稚弱	viro
纸伞	visj
滞涩	vise
致死	visi
止松	viss
止嗽	visz
植酸	visr
之塔	vita
旨泰	vitd
治瘫	vitj
制糖	vith
织铁	vitp
支托	vito
支应	viyk
纸扎	viva
知州	vivz
织鬃	vizs
中班	vsbj
种别	vsbp
种差	vsia
终池	vsii
种畜	vsiu
重锤	vsiv
中词	vsci
重挫	vsco
中稻	vsdc
钟鼎	vsdk
种痘	vsdz
中耳	vser
中耕	vsgg
仲氦	vshd
中号	vshc
中焦	vsjn
仲晶	vsjk
中军	vsjy
中看	vskj
重颏	vske
中空	vsks
重链	vslm
种鳞	vslb
钟楼	vslz
重矛	vsmc
种苗	vsmn
种名	vsmk
中魔	vsmo
中牟	vsmu
中脑	vsnc
中宁	vsnk
种牛	vsnq
中农	vsns
重炮	vspc
中频	vspb
中瓶	vspk
终破	vspo
中铺	vspu
种禽	vsqb
衷曲	vsqu
种群	vsqy
终霜	vsul
重水	vsuv
忠顺	vsuy
众说	vsuo
螽斯	vssi
终岁	vssv
中选	vsxr
重曰	vsyt
中寨	vsvd
中站	vsvj
中正	vsvg
中州	vsvz
中装	vsvl
洲邦	vzbh
周报	vzbc
皱襞	vzbi
周朝	vzic
咒符	vzfu
肘拐	vzgk
昼光	vzgl
肘篌	vzhz
啁啾	vzjq
轴距	vzju
周口	vzkz
轴撩	vzln
轴面	vzmm
皱皮	vzpi
舟桥	vzqn
舟曲	vzqu
周荣	vzrs
绉纱	vzua
咒术	vzuu
轴套	vztc
轴突	vztu
轴瓦	vzwa
肘窝	vzwo
诌系	vzxi
周岫	vzxq
珠蚌	vubh
贮备	vubw
筑宾	vubb
助残	vucj
猪草	vucc
珠层	vucg
煮茶	vuia
珠串	vuir
主从	vucs
诸多	vudz
主儿	vuer
嘱告	vugc
助耕	vugg
朱红	vuhs
朱槿	vujb
珠孔	vuks
住口	vukz
主库	vuku
主料	vuln
猪苓	vulk
竹笼	vuls
苎麻	vuma
柱面	vumm
猪苗	vumn
竹篾	vump
诛求	vuqq
主上	vuuh
祝颂	vuss
主厅	vutk
驻屯	vuty
猪娃	vuwa
助学	vuxt
逐月	vuyt
主政	vuvg
猪猪	vuvu
猪鬃	vuzs
抓差	vxid
抓点	vxdm
抓丁	vxdk
爪儿	vxer
抓手	vxuz
抓走	vxzz
专八	vrba
转包	vrbc
专差	vrid
转抄	vric
砖雕	vrdn
专访	vrfg
转户	vrhu
转筋	vrjb
转矩	vrju
专控	vrks
转口	vrkz
转脸	vrlm
转轮	vrly
专名	vrmk
砖坯	vrpi
转天	vrtm
转引	vryb
转赠	vrzg
转租	vrzu
装船	vlir
状的	vlde
壮工	vlgs
装裹	vlgo
壮怀	vlhk
壮阔	vlko
庄浪	vllh
装料	vlln
状貌	vlmc
壮苗	vlmn
撞骗	vlpm
装入	vlru
装设	vlue
壮肾	vluf
撞锁	vlso
撞头	vltz
壮伟	vlww
壮心	vlxb
装熊	vlxs
壮血	vlxt
锥摆	vvbd
追逼	vvbi
追兵	vvbk
追惩	vvig
追肥	vvfw
追根	vvgf
椎弓	vvgs
追怀	vvhk
追还	vvhr
追魂	vvhy
追歼	vvjm
椎孔	vvks
追凉	vvll
追猎	vvlp
缀鳞	vvlb
追命	vvmk
追授	vvuz
追想	vvxl
坠崖	vvya
赘疣	vvyz
追月	vvyt
追赠	vvzg
准话	vyhx
准将	vyjl
准模	vymo
准谱	vypu
准线	vyxm
准信	vyxb
准直	vyvi
桌案	voan
酌办	vobj
拙笨	vobf
着床	voil
酌点	vodm
酌定	vodk
卓方	vofg
卓菲	vofw
卓夫	vofu
卓卡	voka
灼烤	vokc
卓莱	vold
浊浪	volh
浊流	volq
卓迈	vomd
卓尼	voni
擢升	voug
卓舒	vouu
浊水	vouv
卓威	voww
擢用	voys
涿州	vovz
自拔	ziba
紫草	zicc
自测	zice
子层	zicg
紫灯	zidg
紫逗	zidz
自反	zifj
秭归	zigv
自可	zike
紫蔻	zikz
子类	zilw
字量	zill
紫苓	zilk
字码	zima
籽苗	zimn
子囊	zinh
自能	zing
字旁	ziph
字片	zipm
恣情	ziqk
自圈	ziqr
紫杉	ziuj
自伤	ziuh
渍水	ziuv
紫檀	zitj
紫藤	zitg
子图	zitu
自外	ziwd
紫菀	ziwj
自相	zixl
自展	zivj
资政	zivg
子洲	zivz
紫装	zivl
自足	zizu
子座	zizo
纵波	zsbo
总产	zsij
总店	zsdm
宗法	zsfa
纵隔	zsge
总行	zshh
棕黑	zshw
棕红	zshs
棕黄	zshl
宗匠	zsjl
纵酒	zsjq
总科	zske
棕狼	zslh
纵令	zslk
纵模	zsmo
宗亲	zsqb
宗人	zsrf
宗萨	zssa
总社	zsue
鬃刷	zsux
总校	zsxn
棕眼	zsyj
总政	zsvg
总装	zsvl
奏本	zzbf
走笔	zzbi
走查	zzia
邹城	zzig
走调	zzdn
走访	zzfg
奏捷	zzjp
走口	zzkz
走马	zzma
邹平	zzpk
走色	zzud
奏疏	zzuu
走水	zzuv
走脱	zzto
走形	zzxk
走穴	zzxt
奏议	zzyi
走嘴	zzzv
组胺	zuan
组办	zubj
组编	zubm
祖产	zuij
足赤	zuii
祖德	zude
租佃	zudm
组雕	zudn
卒读	zudu
祖尔	zuer
祖法	zufa
租房	zufg
租费	zufw
组稿	zugc
足光	zugl
租户	zuhu
组画	zuhx
阻抗	zukh
组块	zukk
足乐	zule
族类	zulw
祖龙	zuls
祖罗	zulo
祖率	zulv
阻难	zunj
阻尼	zuni
租钱	zuqm
阻燃	zurj
租让	zurh
祖述	zuuu
足爽	zuul
租税	zuuv
足癣	zuxr
祖茔	zuyk
钻床	zril
钻地	zrdi
钻工	zrgs
钻骨	zrgu
钻机	zrji
钻谋	zrmz
钻取	zrqu
钻塔	zrta
钻台	zrtd
罪案	zvan
嘴笨	zvbf
罪错	zvco
最多	zvdz
嘴乖	zvgk
醉汉	zvhj
最末	zvmo
嘴勤	zvqb
罪囚	zvqq
嘴山	zvuj
嘴碎	zvsv
嘴损	zvsy
嘴头	zvtz
醉蟹	zvxp
嘴直	zvvi
嘴子	zvzi
遵奉	zyfg
尊号	zyhc
尊亲	zyqb
尊翁	zywg
鳟鱼	zyyu
尊者	zyve
柞村	zocy
坐待	zodd
做活	zoho
佐酒	zojq
坐具	zoju
佐凯	zokk
佐拉	zola
座狼	zolh
佐宁	zonk
左迁	zoqm
做亲	zoqb
左倾	zoqk
左权	zoqr
作色	zose
坐堂	zoth
作痛	zots
左舷	zoxm
做小	zoxn
作协	zoxp
作兴	zoxk
作哑	zoya
作阳	zoyh
作乐	zoyt
左云	zoyy
左爪	zovc
座钟	zovs
坐罪	zozv
	
	
